1000
carladavid: upper upper lower middle lower upper lower lower upper upper middle middle middle upper lower middle upper upper upper class
josekarl: lower middle upper lower lower lower middle upper middle class
suecharles: middle lower upper middle upper middle upper lower lower upper middle middle upper middle middle lower middle upper middle lower middle class
karlluann: middle middle lower lower middle upper lower lower lower middle lower middle middle lower lower lower upper upper upper lower upper upper middle middle lower upper middle class
bobrich: upper lower middle lower middle middle lower upper upper middle upper lower class
bobrick: upper class
edluann: middle lower lower upper lower upper lower lower class
harrypati: lower upper middle upper lower upper middle middle lower middle class
bobed: lower lower upper lower upper middle upper lower upper middle lower lower middle class
tomstan: lower middle upper upper lower middle lower upper lower upper upper lower middle upper lower class
bobtommy: lower lower middle upper upper class
stanstanley: upper middle middle upper middle upper upper lower middle middle class
garyxavier: upper lower class
carldeanna: upper lower lower lower lower middle lower upper middle middle lower upper lower middle lower middle middle middle upper middle lower class
johndick: lower upper upper middle upper upper upper middle upper upper lower lower lower lower upper upper upper middle middle lower lower lower middle lower class
suejose: middle middle upper upper middle upper upper middle upper class
paticarla: lower lower middle middle middle lower middle upper middle middle lower upper lower upper lower upper upper upper class
jackxavier: middle middle upper lower middle upper upper middle upper upper middle lower lower lower lower upper middle middle class
edmona: upper upper middle middle upper upper lower upper middle upper middle upper upper lower upper lower middle upper middle upper upper middle middle upper lower middle upper class
patiwendy: middle lower middle lower middle middle middle middle upper lower upper middle middle lower lower lower lower lower upper upper middle upper upper upper class
xaviergary: middle lower upper middle upper upper upper upper upper lower middle lower upper lower lower upper upper lower lower lower lower lower lower upper middle class
patriciamona: upper upper middle middle upper upper upper upper upper upper upper middle middle middle middle middle middle upper lower middle lower lower middle lower middle class
xaviermonica: middle lower upper upper lower middle lower lower class
monicajeff: upper middle lower lower upper upper middle lower upper upper middle middle lower upper lower class
danafrank: middle middle middle upper upper lower middle lower upper lower upper upper class
suerich: lower upper lower upper middle lower middle lower middle lower middle middle middle middle lower middle middle lower upper upper class
franzluann: lower middle middle middle lower lower upper lower middle lower upper middle lower lower lower upper middle class
franzbob: upper middle middle class
deannatommy: middle lower lower middle lower class
johnrichard: middle upper lower lower middle middle lower lower class
dickluann: middle upper lower lower middle middle upper middle lower lower lower lower middle middle lower lower lower lower lower lower upper middle lower class
hansstanley: lower lower middle lower upper upper upper middle lower middle lower upper upper lower lower middle upper lower class
bobcharles: upper middle middle lower middle lower middle lower lower upper middle lower upper upper middle middle upper lower lower upper upper upper upper middle upper middle middle class
charlescarla: middle lower class
edbill: middle lower upper middle lower lower middle middle lower class
frankdeanna: lower upper lower middle upper middle upper lower upper upper lower lower middle lower upper upper lower lower lower lower lower middle middle middle upper class
richharry: middle lower upper middle upper middle lower lower upper middle middle middle middle lower class
monaviolet: middle upper lower middle lower middle upper upper lower lower upper lower middle lower upper upper upper middle class
tommyfrank: middle upper upper lower upper upper lower middle middle upper upper lower lower lower middle lower upper upper middle middle upper middle lower upper class
maryluann: upper middle middle upper middle middle upper lower upper lower lower middle upper class
bobmarian: upper lower upper lower middle middle lower middle lower middle middle lower upper middle upper lower upper middle lower middle class
monarick: upper lower lower middle middle class
garysue: middle upper lower middle lower middle lower middle middle upper upper middle middle upper lower middle upper class
marypatricia: upper lower middle middle lower lower middle middle middle middle class
xaviermary: middle middle middle middle upper lower class
josemary: upper upper upper class
monastan: lower lower middle middle upper class
edmary: middle upper lower middle lower middle lower upper middle middle upper upper lower class
stanleyanne: lower upper middle lower middle middle middle middle class
edmonica: lower lower lower middle lower lower middle middle upper middle middle middle upper middle middle lower upper upper upper upper lower class
patriciajose: lower middle lower upper middle middle upper lower middle middle upper lower lower middle lower class
rickanne: upper lower middle upper upper lower class
charlesjack: middle lower lower lower upper class
patriciaviolet: upper lower upper middle lower lower lower lower upper middle middle lower upper upper upper upper upper upper class
patricialuann: middle class
annedeanna: middle middle lower middle lower middle class
josemarian: middle lower middle lower upper lower middle upper upper lower middle upper class
billmonica: middle middle lower middle lower upper middle upper upper middle lower lower middle middle upper middle upper upper lower upper middle class
beamarian: upper lower lower middle lower upper upper middle lower middle upper middle middle lower lower middle upper middle middle middle middle class
stanmona: upper lower middle middle upper upper upper upper middle middle middle lower middle upper class
davidpeter: lower middle class
tommarian: middle upper upper middle middle upper upper lower middle lower lower upper middle upper lower middle middle upper lower middle upper lower upper upper middle upper middle class
bobsue: middle upper class
annefrank: upper middle middle middle lower lower upper lower lower middle upper upper upper lower lower middle upper middle middle upper lower class
tomkarl: lower upper upper upper upper middle middle lower lower upper middle upper middle lower upper lower lower lower lower upper upper upper upper upper middle upper class
stanleypati: upper upper upper middle lower middle upper middle lower upper lower upper lower class
violettom: lower upper upper lower middle upper upper lower middle upper class
marycarla: lower lower upper upper lower upper upper upper middle upper middle upper upper upper class
mariananne: middle lower class
petergary: lower lower upper middle upper lower lower upper lower upper upper lower middle lower middle middle lower upper upper upper upper class
johnanne: middle upper middle lower lower middle middle lower middle lower middle middle middle class
rickmark: lower class
harryed: middle middle lower lower upper upper lower upper class
richfranz: upper lower lower middle middle lower lower middle lower middle upper lower middle middle upper upper lower class
annewendy: upper middle upper lower upper upper middle lower class
williamfrank: middle lower upper middle lower middle middle lower lower middle upper middle upper middle middle upper class
richtom: middle middle upper upper middle middle upper lower lower upper middle lower middle class
franzwilliam: middle lower class
karlstan: upper upper upper lower middle upper upper lower lower middle middle upper lower lower upper middle class
carlamark: lower class
wendyarnold: upper middle lower lower lower middle middle middle upper middle upper middle middle lower lower middle upper middle class
annejeff: upper lower lower middle class
charlesstan: middle middle lower middle middle upper middle middle lower middle lower class
frankjeff: middle upper middle lower lower upper middle upper lower lower upper class
patistanley: middle lower middle lower lower middle lower middle middle upper upper lower upper lower middle lower lower lower class
charlesjohn: middle lower upper middle middle upper lower middle lower upper lower lower upper lower upper upper upper class
frankbea: upper upper middle middle upper upper lower middle middle upper middle middle lower upper lower lower middle middle upper middle lower upper class
dicksue: middle upper lower middle upper middle middle upper lower lower middle lower middle lower upper lower lower class
arnoldmona: middle upper middle upper lower lower upper upper lower lower lower upper lower lower upper lower middle upper upper upper middle class
carlxavier: upper middle upper lower lower lower upper upper upper lower lower upper lower lower upper upper middle lower middle upper middle middle lower upper upper lower middle class
suemonica: upper lower middle upper lower lower lower upper middle upper lower upper class
joseluann: middle class
rickviolet: upper upper class
garyrick: upper upper middle lower lower middle lower lower upper middle upper upper class
tomcharles: middle middle lower upper middle middle upper upper upper lower class
jeffwendy: upper lower upper lower middle upper middle lower middle lower upper lower lower upper upper lower upper upper class
billmona: lower class
wendymary: lower lower upper class
peterjeff: lower lower middle middle upper lower upper class
monajohn: middle middle upper middle lower upper middle middle middle upper middle middle lower middle upper upper lower middle upper lower lower upper middle lower lower upper class
hansed: upper lower lower upper lower upper middle upper upper middle lower middle middle upper lower lower upper middle upper lower class
annehans: lower middle lower lower middle upper middle upper lower lower middle middle class
dickbea: upper middle upper middle middle lower lower class
mariancarl: middle class
rickdana: lower lower lower upper lower lower class
danabob: upper upper middle middle upper upper lower middle lower lower upper middle upper lower middle lower upper class
jeffcarl: middle upper middle upper class
wendybill: lower middle middle lower lower upper lower upper middle lower upper lower class
stanbob: middle upper upper upper lower middle middle upper lower upper lower middle upper lower upper upper class
hansgary: lower upper middle middle middle upper middle lower middle upper upper lower upper upper lower upper upper upper class
paticharles: upper middle class
patied: upper middle lower middle upper lower lower middle lower middle lower class
monicamona: lower upper lower upper lower lower middle middle lower middle middle lower middle lower middle upper upper upper class
sueluann: upper lower upper lower lower middle middle upper lower lower lower middle upper upper lower middle upper middle upper middle class
bobbob: middle upper middle class
frankbob: middle lower middle upper lower upper lower lower lower middle middle lower middle upper middle middle middle upper lower upper middle lower upper class
wendycharles: middle upper middle middle upper lower middle lower middle middle lower middle lower middle upper class
carlbill: middle upper upper middle middle upper upper upper upper upper upper lower upper middle lower middle lower middle upper lower lower upper class
edwendy: lower lower middle upper middle upper middle middle middle lower lower upper middle upper middle lower middle lower lower lower middle upper middle upper class
richpeter: upper middle lower middle lower middle middle upper lower middle upper middle lower lower middle lower upper middle middle middle lower lower lower lower lower class
williamcharles: upper upper upper upper lower upper lower lower lower lower lower upper upper upper upper middle lower middle lower middle upper upper class
deannaviolet: upper lower upper lower upper upper lower upper upper middle middle lower middle upper upper middle upper middle lower lower upper upper middle upper lower class
xavierdavid: upper lower lower lower middle middle lower lower class
jackrich: lower middle upper lower middle lower lower upper upper middle lower upper middle middle middle lower middle lower upper lower upper middle lower lower class
marypeter: lower upper lower upper lower middle upper lower middle lower class
johnbea: lower lower upper upper middle upper upper middle middle upper lower upper upper upper middle upper middle lower class
karlsue: lower lower middle lower middle middle lower lower middle upper upper upper lower class
johnstanley: upper upper lower lower upper lower upper middle lower middle middle upper upper lower lower lower upper lower upper lower middle upper class
monapeter: upper lower middle upper lower upper upper middle upper middle upper upper class
danaarnold: middle class
davidstanley: upper middle middle upper lower upper lower lower upper lower lower upper upper upper upper lower class
markwilliam: lower middle lower middle lower upper lower upper middle middle middle lower lower lower lower upper upper middle lower lower upper upper middle upper middle middle class
josemona: upper upper middle middle upper class
deannafrank: lower upper upper lower middle upper lower middle middle lower lower upper upper middle middle upper middle middle lower upper lower class
jacked: upper upper middle upper middle lower middle middle class
davidbob: lower upper lower middle lower lower upper lower middle lower upper lower lower upper class
charlesgary: middle middle upper upper middle lower lower upper lower middle upper class
suefranz: lower upper lower middle upper upper middle upper lower upper upper upper middle upper upper upper upper lower middle middle upper upper middle middle upper middle middle class
stanrichard: middle lower middle upper lower lower middle upper lower upper lower upper upper middle middle lower upper upper class
richjose: lower middle middle class
richardcharles: middle lower upper upper lower upper class
hansmona: upper middle upper upper upper upper middle lower middle middle class
carlajeff: lower middle middle middle upper upper lower lower upper upper upper middle middle upper middle middle middle lower lower upper middle lower middle lower class
suerick: middle middle middle lower lower middle lower lower lower lower upper lower upper lower middle middle lower class
franzsue: upper upper upper middle upper upper upper middle lower middle middle class
monamary: middle lower class
violetjose: middle middle lower middle middle upper lower upper middle upper upper middle upper middle middle lower upper lower upper lower upper upper middle lower middle class
annetom: middle upper lower upper lower upper middle middle upper upper middle lower lower middle middle middle upper lower middle middle lower middle lower lower lower lower lower class
richdeanna: lower middle upper middle upper middle lower lower middle lower lower upper lower lower lower middle class
petercharles: middle lower middle lower lower upper middle lower upper upper middle upper middle lower upper class
bobwendy: lower upper upper lower middle lower class
jackfranz: upper lower middle middle upper upper lower upper middle middle lower upper middle lower lower upper lower class
marianviolet: middle lower upper middle lower upper lower middle lower lower upper lower middle class
jackarnold: upper lower lower upper upper middle lower middle middle middle class
monicabill: middle lower lower middle upper upper middle lower lower class
garystanley: lower lower lower middle upper middle upper middle lower lower upper upper upper upper upper lower middle lower upper lower middle middle middle middle upper lower upper class
suedana: upper middle upper lower lower lower lower lower lower upper middle class
markrichard: upper lower upper lower upper upper middle middle upper lower middle middle lower upper lower upper upper upper upper lower lower upper upper upper middle class
franzfranz: lower class
wendyanne: lower middle middle lower middle lower lower upper lower lower lower class
rickcarla: middle lower upper class
bobhans: middle lower middle middle upper middle upper middle middle upper lower upper lower lower middle upper middle upper upper lower lower lower class
jackdeanna: middle middle middle upper upper upper middle middle middle upper class
monajack: lower class
mariangary: lower lower middle lower upper upper upper upper lower upper upper lower middle lower middle middle lower middle middle middle upper middle middle upper upper class
luannwendy: middle middle upper middle lower lower middle lower lower class
franzjeff: lower upper lower upper middle upper upper middle upper middle middle lower upper middle lower middle lower middle class
marianharry: upper middle upper lower upper middle upper middle upper lower lower middle upper middle lower middle class
richardjack: upper middle middle lower class
luannluann: upper upper middle upper middle middle middle middle upper class
williamharry: lower upper middle upper lower lower middle middle upper middle class
patriciadavid: upper middle middle middle lower middle lower lower middle upper middle upper lower middle upper middle middle lower upper upper middle lower upper upper class
bobmonica: upper upper lower lower upper lower lower middle lower middle lower lower middle upper middle upper middle upper middle middle lower lower class
violetcharles: upper lower lower middle middle lower upper middle upper upper lower class
carlpeter: middle middle upper lower lower middle lower upper class
markcarla: upper class
luannanne: lower middle middle middle lower upper lower upper upper upper upper upper lower middle lower class
beaxavier: lower lower lower class
charlesed: lower upper lower middle lower middle lower middle lower lower middle upper class
annemonica: middle middle lower upper upper lower lower lower middle lower middle lower lower lower upper class
carlharry: lower middle upper middle class
suefrank: middle lower middle middle upper lower middle lower class
luannpatricia: upper middle lower lower upper upper lower lower middle upper middle middle middle upper middle upper lower upper upper upper lower lower lower upper middle class
patriciacharles: upper class
arnoldtommy: middle lower upper upper upper upper lower lower lower middle middle upper middle upper middle upper middle upper middle lower upper middle middle lower upper upper class
harryluann: middle middle lower middle middle upper middle middle class
jackbea: middle middle lower lower middle lower lower upper middle upper upper middle lower upper lower lower lower lower middle lower class
sueviolet: upper middle upper middle upper upper middle upper middle lower middle lower upper middle middle class
charlesrichard: lower middle upper middle lower lower middle lower lower class
josejose: middle lower middle lower middle upper upper lower lower middle upper middle upper lower middle upper upper middle upper upper upper lower class
garydavid: upper lower lower lower lower lower upper upper middle middle lower upper middle class
monafranz: upper lower upper upper middle middle upper upper lower middle lower class
maryjohn: lower middle middle upper middle middle upper upper upper middle lower upper upper middle upper lower upper middle class
carlagary: upper middle lower upper middle upper lower upper upper lower upper upper lower lower lower upper lower upper upper lower middle lower upper lower lower lower middle class
annedana: upper lower middle middle middle upper lower middle middle upper middle middle upper class
edjose: upper lower upper lower lower upper lower upper lower lower lower lower middle lower lower upper middle lower lower middle class
harrystan: upper lower upper middle upper upper middle middle middle middle middle class
rickharry: upper middle middle middle middle middle class
patisue: upper upper lower upper lower lower upper lower middle middle upper lower upper middle upper middle upper lower upper middle upper class
stanleycarl: lower lower lower class
richardpeter: middle upper middle lower upper upper upper upper middle lower upper middle middle lower middle upper class
josejack: lower lower middle upper middle lower upper lower middle lower upper middle upper upper upper upper upper lower upper middle upper lower middle upper class
harryharry: middle lower middle middle upper lower middle lower upper middle lower middle lower lower upper upper lower middle middle upper upper middle lower middle upper class
patriciaharry: upper lower middle middle middle lower upper upper lower lower middle upper class
annebob: middle upper lower lower middle lower upper middle lower upper middle middle upper class
carlacharles: lower upper middle middle upper upper middle middle upper lower upper middle middle lower middle upper lower lower lower middle lower upper middle class
jackjohn: middle upper upper upper lower middle class
bobmary: lower upper upper upper upper upper middle upper middle upper middle class
danarick: lower class
tomtom: lower middle middle upper middle lower upper middle middle upper upper upper upper upper middle middle lower middle class
markhans: middle class
xavierpati: upper upper lower middle upper lower middle middle lower upper upper lower upper middle middle lower middle upper lower middle class
deannasue: lower upper middle upper middle upper lower lower lower lower middle upper lower lower upper lower lower middle upper upper lower lower upper middle upper class
danastan: middle lower lower upper lower middle middle class
frankarnold: lower upper middle lower middle middle upper lower upper lower middle lower lower class
richardhans: middle lower middle upper middle lower middle middle lower middle upper upper upper lower lower middle upper upper lower upper upper class
richardtom: upper lower middle upper middle upper lower upper middle lower middle lower lower class
annegary: middle lower upper middle lower lower middle upper upper upper lower upper lower lower lower middle upper middle lower middle upper upper class
markmark: middle lower middle lower class
monicapeter: upper lower lower lower middle lower upper lower lower class
karlrich: lower upper upper upper middle middle upper class
markpatricia: lower lower middle middle upper lower middle middle lower lower upper middle upper upper lower upper class
johnmonica: upper upper lower middle middle upper upper class
billstanley: lower middle lower lower middle lower upper upper middle upper lower middle lower middle middle lower class
danajack: upper upper upper lower upper middle lower middle upper lower middle middle middle middle middle lower middle lower middle middle upper class
tommypatricia: upper middle upper class
rickpeter: middle upper middle upper middle class
beacarla: lower lower upper upper middle middle middle lower middle upper middle middle upper upper lower upper lower upper class
violetgary: middle class
patriciarich: lower middle upper lower middle lower upper class
jackpatricia: lower middle upper upper upper lower class
tomwilliam: middle lower middle class
bobviolet: upper upper lower lower upper middle upper upper upper lower middle middle middle upper lower lower class
johnmark: lower upper lower middle middle upper upper middle lower lower middle middle lower middle middle lower middle upper upper middle lower class
peterbea: upper class
violetstan: lower upper lower middle middle upper lower class
williamhans: lower class
annestanley: lower lower middle middle middle middle lower middle middle upper upper lower lower middle class
dickmona: middle upper upper middle middle lower upper middle lower lower upper upper class
danamary: upper lower middle middle lower middle middle middle upper middle upper lower upper middle middle upper upper upper lower lower middle class
carlaviolet: middle upper lower lower upper middle middle upper middle middle upper upper middle lower middle middle class
tomtommy: middle upper middle upper upper upper upper middle middle lower class
jeffbill: lower lower middle upper upper middle upper upper class
dickcharles: upper middle lower lower middle lower upper middle middle lower middle upper upper middle class
edbea: middle middle upper upper middle lower middle middle lower lower upper upper middle upper upper upper middle upper upper upper upper lower upper middle middle middle lower class
jeffharry: upper middle upper lower upper lower lower middle lower middle middle middle lower middle upper upper upper upper upper lower upper class
peterfranz: upper upper middle lower lower middle upper upper middle upper middle lower middle middle lower middle upper upper middle lower lower lower lower lower upper upper lower class
marymark: middle lower upper middle middle lower lower upper lower upper upper lower upper upper middle middle lower lower lower middle upper middle middle class
markdick: middle middle upper lower class
garyjeff: middle upper middle lower middle upper lower upper lower lower lower middle lower lower middle lower lower lower upper lower upper lower lower lower middle class
rickfranz: lower lower upper upper middle lower upper middle lower upper middle upper lower upper class
josebob: upper lower middle lower middle upper middle lower middle upper middle middle lower middle upper upper middle upper middle lower upper class
danaanne: middle upper lower middle upper middle middle lower lower class
johnhans: lower upper upper middle upper upper upper middle middle middle middle middle middle lower middle middle upper class
davidbill: middle lower middle lower upper middle upper lower upper middle lower lower lower lower upper class
mariandick: lower lower lower middle class
marianmona: lower upper middle middle middle lower lower lower middle middle middle lower lower lower upper upper upper middle middle upper middle class
annejose: middle middle lower class
violetmona: lower upper middle upper middle middle middle lower middle middle middle upper upper middle lower upper lower middle upper upper lower middle lower class
davidmarian: middle lower lower upper middle upper middle middle middle middle middle class
markpati: upper middle middle lower middle upper upper upper upper middle lower upper lower middle upper middle class
bobpati: lower upper lower lower middle lower lower lower lower upper upper class
xavierdana: upper lower lower middle upper middle upper lower upper upper middle middle middle upper lower upper upper lower class
jefffrank: lower upper lower class
garybill: upper upper upper upper lower lower middle middle lower lower upper lower lower class
davided: middle middle middle lower lower middle middle upper upper middle upper middle upper upper upper upper upper upper upper class
peterbob: lower middle lower middle lower upper lower class
monagary: upper middle upper upper middle lower upper middle middle upper lower middle middle lower middle middle upper middle middle upper lower lower middle upper middle middle middle class
patriciatom: middle middle lower middle lower lower middle lower lower upper lower upper lower lower upper upper upper upper middle lower lower lower middle lower lower middle lower class
beabob: upper lower upper upper upper lower upper lower middle lower upper middle middle middle upper upper lower lower lower upper lower class
wendysue: lower upper middle middle upper lower middle lower lower upper upper lower middle class
arnoldluann: middle class
davidjeff: lower middle middle lower upper middle upper lower class
billviolet: upper middle lower middle lower upper lower lower lower lower lower lower lower upper middle lower upper upper upper middle lower middle middle middle class
franzcharles: lower middle middle middle middle upper lower lower lower upper lower upper middle upper upper middle lower lower middle middle upper middle middle middle lower class
rickmona: middle middle lower middle upper lower middle lower upper lower upper lower middle middle lower lower upper lower lower class
carlastanley: middle upper middle lower lower lower lower upper middle upper class
patriciapatricia: lower lower lower lower upper upper middle upper upper middle upper lower upper upper upper lower lower upper upper upper lower lower upper middle class
harryjohn: upper middle lower lower lower lower middle upper upper upper middle middle lower middle middle upper middle upper middle middle upper middle middle class
tomarnold: lower middle upper middle upper upper middle upper middle upper upper lower class
luanndavid: lower middle middle middle middle class
xavierharry: middle middle upper lower middle upper upper upper upper middle class
davidcarla: lower middle upper middle upper middle upper lower lower lower upper upper lower class
arnoldwilliam: lower upper middle middle upper lower middle upper upper lower upper upper upper upper middle lower upper middle upper upper lower lower middle upper lower lower class
patiwilliam: upper middle lower lower middle middle lower class
arnoldpatricia: middle lower middle middle lower upper class
harrymona: lower middle middle middle upper upper upper lower upper lower upper middle upper lower middle lower middle lower lower middle lower middle lower class
stanhans: lower upper lower upper upper lower upper lower upper upper upper lower upper upper upper upper lower upper upper middle middle middle middle class
charlesdeanna: lower middle upper middle lower upper lower lower upper upper middle middle lower middle middle middle upper middle middle lower middle upper upper upper upper class
stanwilliam: lower lower middle lower middle upper lower middle lower lower middle lower upper lower lower middle upper lower middle lower middle upper upper lower class
patipeter: lower middle lower upper upper middle middle upper upper lower class
frankdick: middle class
franzcarl: upper lower lower upper middle lower lower middle upper lower middle middle upper middle upper lower upper middle upper upper middle lower middle class
billbill: middle upper upper middle lower middle middle lower lower upper lower lower lower middle lower lower middle upper upper lower lower lower middle middle upper upper middle class
bobdana: middle middle middle upper upper middle class
hansjack: upper upper middle class
williamcarl: middle middle middle middle lower middle upper middle lower middle upper upper lower middle lower upper lower middle lower middle upper lower middle upper upper lower lower class
monicadick: upper upper class
stantom: middle lower lower upper lower lower upper lower middle upper upper upper lower lower class
luanncarla: upper middle lower middle upper middle middle lower middle lower lower lower upper lower upper middle upper upper upper class
deannaanne: upper lower upper middle middle middle middle upper upper middle class
xaviered: upper middle middle lower lower class
billcarl: lower middle lower lower lower middle middle lower upper lower upper middle upper lower upper middle middle lower lower middle lower middle lower class
rickkarl: upper upper upper upper upper middle lower lower middle middle middle class
richdavid: lower class
hansmary: lower middle lower upper lower middle lower lower middle upper middle class
patriciarichard: lower middle lower lower middle class
annepeter: upper middle lower class
dickmark: lower upper lower lower upper upper middle lower upper middle middle lower lower middle lower middle upper middle upper lower middle middle lower upper upper upper lower class
maryrich: middle middle upper lower upper lower middle lower upper lower lower upper middle lower upper upper upper class
monicastan: middle class
williamgary: upper class
tommywendy: lower upper upper middle upper upper middle lower middle middle upper middle lower middle lower upper lower lower middle middle middle upper lower lower class
billfrank: upper upper lower middle middle upper middle middle upper middle upper middle middle middle lower lower middle lower middle upper class
richarddavid: middle middle lower upper lower lower middle class
violetbill: middle upper upper lower middle lower lower middle middle lower middle middle upper lower upper upper lower middle middle middle middle upper lower upper middle class
monaluann: upper middle upper lower lower middle upper upper lower upper lower middle class
edhans: middle upper lower upper class
richardstan: middle middle upper middle middle upper middle lower class
deannabob: upper lower middle lower middle lower middle lower middle middle lower lower upper upper middle middle class
tommybill: upper lower middle class
wendymark: middle upper middle upper upper middle lower lower middle middle lower middle middle lower middle lower middle upper middle middle upper upper lower upper lower lower class
josefrank: upper upper lower class
franzdavid: middle upper lower middle lower class
jeffstan: upper upper lower upper middle upper upper middle middle middle class
suestan: upper lower middle upper upper middle middle upper middle middle upper lower middle upper lower upper upper lower upper lower upper middle lower lower middle upper class
richardkarl: upper upper lower upper lower lower middle class
hanspeter: upper upper middle upper lower upper upper upper lower upper lower middle lower middle lower middle lower middle upper lower lower lower middle lower class
wendyfranz: middle middle lower upper middle middle class
davidrick: upper middle middle middle upper upper middle middle upper lower middle middle middle middle middle lower upper upper lower lower lower lower middle lower class
charlescarl: lower upper class
danaxavier: upper lower upper upper lower upper upper upper class
charlespati: middle lower lower lower upper upper middle lower lower upper upper lower upper lower upper upper middle class
billbob: upper middle lower upper lower middle middle upper upper lower lower middle lower lower class
richwendy: lower upper upper middle lower lower upper middle middle lower lower middle upper upper middle lower class
frankrichard: middle upper class
charlesarnold: upper middle middle lower lower upper upper middle middle middle middle upper lower middle middle upper class
richarddana: lower lower middle upper lower lower upper middle upper middle upper upper upper upper lower upper lower lower middle lower upper class
monatommy: upper lower middle lower lower middle upper upper upper middle lower upper lower middle middle upper upper lower class
bobjeff: middle upper lower upper upper lower upper middle middle upper upper lower lower upper upper upper lower upper class
davidwilliam: upper lower upper lower lower upper middle middle class
luannbill: upper lower upper upper lower middle middle upper upper lower lower middle upper lower upper lower middle lower lower upper upper middle upper upper middle class
edrich: lower lower middle upper lower middle lower upper upper upper upper upper lower middle middle middle lower upper lower middle class
garyharry: upper middle lower middle lower upper class
stanleymark: upper lower lower lower lower middle upper middle upper lower class
jeffsue: lower middle middle middle upper upper upper middle lower middle upper upper middle lower upper lower lower middle middle lower class
carlmona: middle upper middle upper upper upper lower upper middle middle middle upper middle middle lower middle lower upper lower middle upper middle middle lower upper class
carlaed: lower upper middle middle lower upper upper upper lower lower lower upper upper lower class
markarnold: upper middle lower upper upper upper upper lower upper upper upper upper lower lower lower upper upper middle upper middle upper class
standick: upper lower upper class
edanne: upper lower middle upper class
dickpati: upper class
williammark: lower middle lower lower upper upper lower middle lower upper middle middle upper lower lower middle lower class
beabill: lower upper upper upper middle upper lower lower middle middle lower upper upper upper lower lower upper lower middle upper upper lower lower upper lower lower middle class
peterrick: lower lower lower lower middle middle middle middle upper upper middle upper upper class
williamdana: middle upper middle middle upper middle class
edrichard: middle middle middle lower upper middle lower lower lower lower lower lower lower upper middle middle lower class
xavierdick: upper upper lower upper middle middle lower lower lower lower upper middle upper middle upper middle lower upper middle upper middle class
richardarnold: middle upper middle lower upper lower upper upper upper upper class
edfrank: middle middle upper upper upper upper middle middle middle middle middle upper lower lower upper middle upper middle lower middle middle lower middle middle class
harrybill: middle middle middle middle lower upper upper upper lower upper lower lower lower middle upper lower lower upper lower lower class
tommymarian: lower middle middle lower class
jackluann: upper middle lower upper upper middle upper middle upper lower lower middle lower middle class
carlcharles: lower middle lower upper upper upper middle upper middle lower upper upper middle middle upper upper middle middle middle class
karlviolet: lower lower middle lower middle middle middle class
monicaharry: upper lower middle middle lower middle middle upper upper upper class
jeffed: lower upper lower upper lower upper upper upper middle lower lower upper lower upper lower lower upper lower upper lower lower upper upper middle lower class
tomed: lower upper upper upper middle middle middle upper lower middle middle lower middle middle class
arnoldpeter: middle upper lower lower upper lower class
jefftom: lower lower lower lower lower lower middle lower middle middle upper middle lower middle middle upper lower upper upper class
petermonica: middle lower middle class
luannfranz: lower middle lower lower lower lower lower upper upper upper middle class
frankjohn: lower upper middle middle upper lower upper upper middle middle middle lower lower upper middle lower class
johnfrank: upper upper middle lower middle lower middle lower middle upper lower class
garycarl: lower middle upper lower middle upper middle class
tommydavid: lower middle class
markwendy: lower middle upper middle class
rickjohn: middle lower upper lower upper upper upper middle lower middle lower lower upper middle middle lower middle class
hanspatricia: middle lower middle upper upper lower lower middle lower middle class
patriciadick: lower middle upper class
patriciaed: middle middle upper lower middle middle lower lower middle middle lower lower upper middle lower lower upper lower middle middle middle lower class
maryxavier: middle middle lower middle upper class
danacharles: lower middle middle middle middle middle middle upper middle middle lower upper lower lower class
patriciaarnold: lower lower upper upper lower lower lower upper middle upper upper middle lower lower middle upper class
edjack: middle lower middle upper lower lower middle class
xavierjose: lower middle middle lower upper upper lower lower upper middle middle lower upper middle middle upper upper middle lower upper upper middle upper lower lower upper upper class
williamdeanna: upper lower middle middle upper lower middle lower upper lower lower middle lower lower middle class
deannatom: lower lower upper upper upper upper lower class
jackrichard: middle middle upper upper upper middle upper lower lower upper middle lower middle middle upper upper lower middle lower middle upper middle lower lower lower middle class
monicarich: middle middle upper lower middle upper lower lower middle lower middle middle lower middle lower middle lower middle upper upper upper class
rickbob: lower lower upper class
billhans: upper lower upper lower lower upper upper upper upper lower upper upper lower upper upper lower lower lower upper middle upper upper lower lower upper lower class
monicawendy: lower lower middle upper middle lower middle upper middle lower middle middle upper upper lower lower middle lower lower middle middle upper upper middle upper class
annejohn: lower middle upper upper lower middle middle middle lower middle middle upper middle upper upper upper lower lower lower lower middle middle upper middle lower middle upper class
stangary: middle middle middle lower upper lower lower lower middle middle lower lower upper middle middle upper middle lower upper middle upper middle upper lower middle upper class
richardpatricia: middle upper middle middle middle upper upper lower upper middle upper lower lower upper middle upper lower middle middle lower upper upper upper lower middle class
monicapati: lower lower lower middle lower lower middle middle lower middle upper upper lower middle upper upper upper middle middle class
deannarichard: upper upper upper upper upper middle middle middle upper upper middle upper lower middle upper middle middle lower class
frankmary: lower lower lower middle upper upper upper middle lower upper lower lower middle middle middle upper lower class
hansjohn: lower middle middle lower upper middle middle upper upper upper upper class
patijose: upper middle middle lower middle middle middle lower lower middle lower upper middle upper middle middle middle upper upper upper upper lower lower lower lower lower upper class
bobfranz: middle middle lower upper upper upper middle lower lower middle middle upper middle lower middle lower middle lower lower lower lower class
franzpatricia: middle upper middle lower middle middle middle middle middle lower upper lower lower lower upper lower upper lower upper lower lower upper class
danastanley: middle lower upper middle upper lower middle lower class
stanleyfranz: upper lower middle upper upper upper lower lower upper upper upper lower lower middle lower lower upper upper middle upper lower middle upper lower middle middle middle class
carlawilliam: lower upper upper upper middle lower middle lower upper middle lower lower middle lower lower lower upper lower middle middle class
karlfranz: upper lower upper lower lower lower upper lower lower lower middle middle middle upper lower lower middle middle lower upper upper class
johnmarian: lower middle lower lower lower lower middle lower upper class
karled: lower middle upper upper class
beadavid: upper middle upper middle lower middle middle lower middle lower middle lower middle middle middle middle class
edcarl: lower upper lower middle class
karlmarian: lower middle upper lower lower middle middle upper middle lower upper middle middle class
deannajohn: lower lower middle lower lower class
annecarl: middle upper lower lower middle lower middle lower lower lower upper lower lower lower middle upper upper lower lower class
markfranz: middle upper middle upper middle upper middle upper upper upper lower lower middle lower middle upper lower middle upper upper upper class
marianbob: upper upper class
davidpatricia: lower middle middle upper middle middle middle upper class
williamanne: middle upper upper lower middle middle lower middle upper lower middle middle upper upper middle upper middle middle class
violetcarl: middle upper lower middle upper upper class
violetbob: upper middle upper lower lower lower middle lower upper middle middle lower upper lower lower middle upper upper upper class
peterxavier: upper upper lower lower middle lower upper upper lower middle upper upper lower middle lower upper lower lower middle upper middle lower class
bobdeanna: lower lower upper upper middle middle lower upper lower lower upper lower lower upper lower upper middle middle middle lower upper lower middle class
richardstanley: middle middle lower lower lower lower middle upper class
deannastan: upper upper lower middle upper middle middle upper lower middle middle middle upper middle middle lower middle lower middle lower upper class
arnoldrichard: upper upper middle lower middle middle lower lower upper upper upper lower middle lower lower lower lower lower upper class
wendytom: middle lower middle middle upper middle class
tomgary: middle middle upper lower lower upper lower middle upper lower middle middle upper upper upper upper lower middle upper upper middle lower middle lower upper class
richbea: lower upper middle upper upper middle middle lower middle lower middle lower middle lower middle middle middle middle upper middle lower class
richardmark: upper upper middle middle lower middle lower middle lower middle lower upper lower lower upper upper middle middle middle middle class
franzdana: lower upper upper lower lower upper middle middle middle upper lower middle upper middle middle upper middle upper lower middle lower upper lower middle middle class
jackgary: lower middle upper middle lower middle lower lower upper lower upper upper upper upper middle lower middle lower middle lower middle upper class
peterluann: middle upper lower middle lower upper upper lower middle middle upper lower lower upper lower upper middle lower lower middle class
edfranz: upper upper middle lower middle middle lower middle middle upper upper upper middle lower upper middle lower upper lower lower middle middle middle lower class
maryarnold: upper upper middle class
monacarla: middle lower lower upper lower middle class
hansmonica: upper lower lower middle lower upper upper middle lower lower lower upper upper middle middle middle class
monicamonica: lower upper upper middle upper upper upper middle upper lower upper middle lower upper middle middle upper middle middle upper lower middle middle upper class
monarichard: lower upper lower middle class
tommyfranz: lower middle lower upper middle middle middle upper middle upper middle upper lower middle class
joseanne: lower lower middle middle upper middle upper class
franzrichard: middle lower upper class
edarnold: upper lower lower lower lower lower middle lower upper class
peterdana: lower middle middle lower upper upper lower middle lower lower upper middle middle middle middle lower middle lower upper middle upper upper middle upper class
marianbea: upper middle middle lower middle lower lower middle lower class
hansdana: middle upper class
karlarnold: upper middle lower middle lower middle middle upper upper upper middle middle upper upper middle upper middle middle lower upper upper class
deannawendy: lower class
billfranz: lower lower lower middle lower upper upper upper lower lower lower middle lower lower upper upper lower lower upper middle upper lower lower middle middle class
charlesbea: lower upper middle upper lower lower upper lower lower lower middle middle upper lower lower upper upper lower middle upper middle lower class
franztommy: upper upper upper lower lower middle lower middle upper middle middle lower lower lower lower upper upper middle class
josefranz: lower upper middle lower upper lower upper upper middle upper upper upper lower upper middle upper lower lower middle middle upper class
arnolded: upper upper upper upper lower upper upper upper lower upper lower lower lower lower upper lower lower upper upper middle upper upper lower lower middle class
carljeff: lower upper class
charlesdavid: middle lower upper upper lower lower lower lower upper upper upper lower middle lower upper middle lower middle lower middle class
bobstan: middle upper lower upper upper middle lower lower middle upper middle lower upper upper lower class
harrywendy: upper middle upper middle upper lower upper lower lower upper upper middle middle middle upper middle middle middle lower lower middle lower middle middle lower upper class
charleswilliam: lower middle middle middle middle middle lower middle middle upper class
stanwendy: lower lower class
franzfrank: middle middle lower middle upper upper upper upper lower lower lower upper middle middle lower lower middle middle middle lower middle upper middle class
garymark: middle lower lower lower upper middle middle lower class
garykarl: middle upper lower middle upper upper upper middle middle lower middle lower lower upper lower lower lower middle middle class
richarnold: lower lower upper lower lower lower lower lower upper lower upper lower middle lower lower upper lower upper middle upper middle upper upper upper middle upper class
bobtom: upper lower upper upper upper upper middle middle lower middle middle class
tommydick: middle class
annepati: middle lower lower upper lower middle class
williambill: upper lower upper upper upper middle middle upper middle class
garyjack: middle lower middle upper upper middle upper middle middle middle lower upper lower middle lower lower middle middle middle middle upper class
charlessue: upper middle upper upper middle lower upper upper middle lower upper lower upper lower upper lower middle upper lower lower lower upper class
arnoldjack: middle middle class
tomstanley: lower upper middle upper lower upper upper class
karldeanna: lower lower middle lower upper middle middle lower middle middle upper lower upper upper upper middle lower class
richgary: lower lower middle middle middle lower lower lower middle middle lower upper middle lower middle upper middle middle upper lower middle upper middle middle middle class
wendywilliam: upper upper lower lower upper upper upper middle upper middle lower upper upper middle upper middle middle lower lower upper middle middle middle lower class
williamxavier: middle middle upper lower middle middle upper upper upper lower lower middle upper lower upper class
rickcarl: upper upper upper upper lower lower lower lower middle middle upper middle lower lower lower lower middle lower class
carlabill: lower lower upper lower class
patitommy: upper upper upper upper middle upper middle lower middle lower lower lower class
beasue: middle middle lower middle middle middle upper middle upper upper middle middle middle lower class
richardbea: lower lower middle upper lower middle upper lower lower middle middle lower middle middle lower middle middle middle class
annemarian: upper lower middle upper middle upper upper middle upper upper middle middle upper upper upper upper upper lower middle upper lower middle middle lower middle class
monacharles: upper upper class
patriciatommy: middle middle upper upper upper middle lower lower upper lower lower middle upper middle middle middle class
charlesdick: lower lower lower middle upper middle class
stanfrank: lower lower middle middle lower middle upper upper middle upper middle middle middle middle lower lower middle middle class
petermarian: lower upper class
suecarla: upper lower upper middle upper middle middle middle middle upper lower upper middle middle middle upper middle lower middle class
carljohn: middle middle middle middle middle middle lower middle upper lower lower lower lower middle lower upper upper class
suedavid: middle upper lower middle middle upper lower middle upper middle lower upper upper middle lower lower class
richardbill: lower upper upper middle class
marianwilliam: upper middle lower lower middle middle middle middle lower middle upper middle middle lower upper middle lower upper upper middle middle middle lower class
karlpati: upper lower lower lower middle middle middle middle class
annedavid: middle upper lower middle middle middle upper upper lower lower lower lower lower class
charlesmark: middle middle upper lower middle middle upper lower upper middle lower upper middle middle upper middle upper lower upper class
garyarnold: upper upper upper middle middle lower upper lower upper upper lower upper lower middle upper middle middle lower lower upper middle middle lower class
markmonica: middle upper upper middle middle lower upper upper upper middle lower upper middle upper lower middle middle middle lower upper upper class
wendyjose: lower lower lower lower middle upper middle lower middle lower lower middle middle middle lower upper middle upper middle middle middle lower upper middle class
petertom: upper upper upper upper upper middle upper middle middle middle lower middle lower class
jeffrick: upper upper middle middle lower upper middle middle class
tommycarla: lower middle middle class
hansdeanna: upper upper middle middle upper upper middle class
violeted: lower middle upper middle lower middle middle lower upper upper middle middle middle class
tommyrick: lower upper upper upper lower middle lower class
arnolddana: upper lower upper lower upper middle middle upper upper middle upper upper lower lower lower lower lower upper lower upper upper lower middle middle class
carlawendy: middle middle middle upper class
richardpati: upper middle middle lower middle lower middle middle upper lower lower lower middle lower lower lower upper lower lower lower lower lower middle upper upper middle class
karltom: middle lower lower lower middle upper middle lower middle upper lower class
johnjack: lower lower middle upper upper middle lower middle middle middle lower upper lower upper upper upper middle upper lower upper middle lower class
annefranz: middle upper middle middle middle middle lower upper upper upper upper lower lower upper upper upper lower lower upper upper upper middle upper lower class
danacarl: middle upper middle lower upper lower upper middle middle upper upper middle upper lower lower upper upper middle upper lower class
stanleykarl: lower upper middle lower middle upper middle upper middle upper upper lower class
garywilliam: middle lower middle middle middle middle middle lower middle lower middle upper upper middle upper lower middle upper lower middle upper upper middle upper upper upper class
stanjack: lower upper middle middle upper upper upper middle upper upper middle middle middle upper middle class
franzed: middle upper lower upper middle middle lower middle upper class
hansfranz: lower middle upper upper lower lower class
carled: middle lower middle middle lower lower middle middle lower middle upper lower lower lower middle middle lower lower lower middle middle upper middle class
monabea: upper upper middle upper lower lower class
carlrichard: lower middle lower upper middle lower lower middle lower upper lower middle middle middle middle middle lower lower lower lower middle class
charlesjose: lower middle lower upper class
arnoldxavier: middle upper upper middle middle middle lower middle middle middle middle middle middle lower upper lower upper lower middle upper lower upper middle class
violetfranz: upper class
beabea: middle lower upper middle lower lower middle lower lower middle middle lower upper lower lower upper middle middle lower upper lower lower middle middle middle lower class
richdick: lower upper middle upper middle upper lower lower lower class
jacktom: upper upper upper middle lower lower lower upper middle class
marianrichard: lower lower middle lower middle upper lower lower upper lower middle class
rickpati: middle upper upper upper middle lower upper lower lower middle upper lower lower middle class
stanleyjose: upper lower middle lower middle middle middle middle upper middle upper upper upper middle middle middle lower lower lower lower upper middle upper upper upper lower class
stanleyrick: middle lower upper lower middle upper class
bobjose: middle middle lower upper upper lower lower middle lower class
richardrich: upper lower lower lower class
markdeanna: middle middle upper lower lower middle upper upper lower upper upper middle class
karlmonica: lower upper upper upper middle middle upper middle class
josehans: upper lower lower lower middle upper middle lower lower upper middle middle upper lower class
deannamonica: middle lower middle lower upper lower upper middle upper lower upper upper upper class
richardxavier: lower class
jeffbob: upper upper upper upper upper upper class
williamrich: upper upper lower upper middle middle class
suebea: lower lower lower lower lower middle upper lower upper upper lower middle middle lower upper middle lower upper lower lower class
davidmary: upper lower upper class
arnoldgary: lower upper upper lower middle middle lower lower class
josedana: lower upper middle upper lower lower lower middle lower middle middle middle class
patriciapeter: lower upper lower lower upper lower upper lower middle lower middle middle middle lower middle middle lower middle upper lower middle lower lower upper class
frankviolet: lower class
jackbill: middle middle lower upper upper lower lower middle lower upper upper middle middle class
daviddavid: middle middle lower middle middle upper lower middle lower middle middle lower middle middle upper middle lower upper lower middle middle upper middle upper class
jackharry: middle middle upper lower middle lower upper upper lower middle lower lower middle lower lower upper class
karlharry: upper lower class
beafrank: lower class
danatom: middle class
deannapeter: lower upper lower lower upper lower upper middle middle lower lower lower lower middle lower middle lower lower middle lower middle lower lower middle lower class
frankhans: upper lower upper upper lower lower lower class
garyluann: upper upper upper middle middle middle upper middle lower middle middle class
beajack: upper lower upper lower upper upper middle upper lower upper middle middle upper class
wendybea: upper upper middle lower middle lower lower upper upper middle lower upper lower lower middle lower lower lower upper lower middle lower upper upper upper class
josesue: lower middle middle middle upper upper middle middle middle middle lower upper upper middle class
carlbob: upper upper lower class
josepati: middle lower upper middle upper lower middle lower middle middle middle middle middle middle middle middle middle lower middle middle class
suecarl: middle middle lower class
monicarichard: middle middle middle lower upper lower upper lower middle lower lower upper upper upper lower lower middle upper upper middle middle lower middle upper lower upper lower class
tommykarl: upper upper lower middle lower upper middle upper lower middle upper upper middle lower lower upper upper lower lower lower class
williampeter: upper class
carlarick: middle upper lower upper middle upper lower lower upper middle upper lower middle upper middle lower upper middle upper class
richkarl: middle lower upper upper class
dickgary: lower upper middle middle upper upper lower upper upper middle lower lower class
stantommy: lower upper lower middle lower upper lower middle middle lower middle class
josestanley: lower upper lower middle upper middle upper middle lower middle upper lower class
stanleymonica: middle upper upper lower upper middle lower upper upper upper upper upper middle class
stanleyviolet: lower upper upper middle lower lower middle upper lower lower middle lower middle upper upper lower lower middle class
harryjose: upper lower middle upper middle lower lower middle lower upper lower lower upper upper lower middle middle lower lower upper class
charlesfrank: middle lower lower middle upper middle middle middle middle upper upper lower lower upper class
markjohn: lower lower middle upper lower lower middle middle lower lower middle middle upper middle middle lower middle class
carlbea: middle lower middle middle middle lower upper middle lower lower upper lower lower upper upper upper lower middle lower lower class
williamed: upper lower middle lower middle middle upper upper middle middle upper lower upper upper middle middle middle middle middle upper lower lower lower class
marianpeter: upper middle middle lower upper upper lower lower middle middle lower upper middle middle lower upper middle middle lower middle lower lower class
maryed: upper lower lower lower middle middle upper middle lower class
frankdana: upper class
xavierdeanna: lower middle middle middle class
davidhans: upper lower middle lower middle middle upper upper middle upper middle middle lower upper upper middle middle lower upper middle middle lower upper class
carlarnold: upper upper lower lower upper upper lower middle upper lower upper upper upper middle lower middle lower class
suejack: lower upper upper lower upper middle upper lower middle class
annecharles: lower middle middle lower middle middle class
annexavier: middle lower upper lower upper lower class
violetmonica: upper upper upper upper upper middle upper lower lower lower upper lower middle upper upper middle upper middle middle middle lower upper class
williamjeff: upper middle middle upper middle lower lower lower lower upper middle lower lower upper upper lower class
jackdana: upper lower middle upper lower lower upper middle lower upper lower middle middle middle class
carlajack: upper lower upper upper middle lower lower lower upper lower lower upper upper lower middle middle upper lower class
dickdick: lower middle lower middle middle lower lower upper upper class
patiharry: lower upper lower upper middle lower middle middle upper middle middle upper class
frankjose: lower upper upper class
rickcharles: upper middle middle upper middle upper lower lower middle middle upper middle class
peterstanley: lower middle upper upper lower class
jackstan: upper lower upper middle lower middle upper lower upper lower upper upper lower middle upper lower lower lower lower middle class
dickfranz: upper middle upper upper upper middle middle class
tomjeff: upper middle upper lower middle middle lower middle upper upper upper lower lower upper middle middle upper class
tomfranz: lower upper middle middle lower lower middle lower middle middle lower middle lower lower upper upper class
frankmonica: upper middle lower middle lower upper lower lower class
davidtommy: middle upper upper middle lower middle lower upper lower upper class
josemonica: middle lower lower middle upper middle upper middle lower upper upper class
violetkarl: middle lower class
arnoldrich: lower middle middle middle lower middle lower upper upper middle middle class
monaanne: middle middle upper class
suekarl: lower lower middle middle middle middle lower middle lower lower upper middle middle lower lower lower upper class
bobpeter: middle class
beawilliam: lower upper class
richjeff: lower lower upper upper middle lower lower class
xavierluann: lower upper middle middle lower lower middle lower middle middle middle class
harryarnold: lower lower lower lower middle upper lower lower upper middle lower upper middle lower middle lower upper lower lower middle upper upper middle middle middle lower class
bealuann: lower lower middle upper lower middle middle lower upper lower lower class
danamarian: middle middle middle middle upper middle upper upper lower middle upper upper lower upper middle upper lower upper lower upper upper lower middle lower middle lower lower class
violetdick: lower middle lower middle middle lower upper lower upper middle lower upper upper class
danacarla: middle class
wendypati: lower lower upper upper middle upper middle upper upper middle lower lower lower middle lower upper middle class
monicaanne: middle lower lower upper upper lower upper middle middle lower class
davidsue: lower lower lower lower lower lower lower upper middle lower lower middle middle lower middle middle upper lower upper middle middle lower lower middle upper lower lower class
bearich: upper upper lower middle middle middle lower lower upper middle lower middle upper lower lower middle middle middle upper class
marianwendy: middle lower lower lower lower class
hansjeff: upper middle lower middle lower lower upper upper middle middle upper lower upper lower lower upper upper class
markcarl: middle middle upper upper upper middle upper middle upper middle upper middle upper middle lower middle lower upper upper class
jacktommy: middle upper middle upper middle lower middle lower upper middle middle lower lower middle lower upper lower middle lower middle middle upper middle middle upper upper class
wendygary: upper upper lower upper middle lower lower upper lower lower lower middle upper middle lower middle lower upper class
stanleysue: lower lower upper middle lower upper middle upper middle lower lower upper upper middle middle upper upper upper lower class
frankbill: lower lower upper upper middle lower middle lower lower middle middle lower middle middle middle middle upper lower lower class
stanbea: lower upper lower middle middle lower middle upper upper lower lower upper lower middle upper upper upper lower upper lower class
arnoldhans: middle lower middle class
danaviolet: middle lower middle lower upper upper lower upper middle middle lower middle lower upper upper middle class
charlesbill: middle middle middle middle middle class
williamsue: upper class
dickpeter: upper upper middle middle upper middle lower upper lower lower lower upper lower upper lower lower middle lower upper lower class
danasue: upper lower middle lower middle lower lower class
davidarnold: upper class
stanjeff: lower upper lower middle middle middle middle lower lower middle upper upper upper lower class
davidjohn: upper upper lower upper upper lower lower middle middle lower middle upper middle upper upper upper upper upper lower middle lower lower upper middle middle upper class
jeffarnold: upper middle middle lower lower lower upper upper lower middle lower lower middle lower upper middle upper lower upper middle lower lower middle upper class
marykarl: upper middle lower upper upper middle middle middle lower upper lower middle upper class
dickfrank: upper middle lower middle middle middle middle upper upper upper upper middle upper upper middle lower lower lower upper middle lower middle class
beakarl: upper lower middle upper middle lower class
suebill: lower middle class
harrystanley: upper upper upper middle middle lower lower upper middle upper upper middle middle middle upper middle lower upper upper upper upper middle middle class
billwendy: upper lower upper lower lower lower upper middle lower middle middle lower lower class
rickstan: lower lower class
patriciabob: lower middle middle lower lower middle upper middle lower middle middle middle middle middle middle middle middle middle middle class
bobluann: lower upper class
josemark: upper middle upper lower upper upper upper upper upper upper lower middle upper upper middle middle upper lower middle upper upper lower middle class
stanleytommy: middle lower upper upper upper middle lower upper lower lower middle middle lower middle middle middle middle lower middle upper upper class
wendyhans: middle upper middle middle middle class
stanleywilliam: middle middle upper middle middle lower upper upper upper lower middle middle middle upper upper class
markrich: lower lower upper middle lower lower middle lower class
xaviercarla: upper middle middle upper lower upper middle lower lower lower upper middle lower middle lower lower lower lower upper upper upper middle middle upper upper middle upper class
harryjeff: middle class
billrichard: upper middle middle upper upper upper class
hansharry: upper middle upper lower lower lower lower upper upper class
patriciahans: middle middle upper upper middle upper lower upper middle upper lower middle lower lower upper lower upper lower lower upper lower class
annearnold: upper middle middle upper lower middle lower middle lower lower upper lower middle middle lower class
hanstom: lower upper upper upper lower middle lower lower lower lower upper middle class
monicaluann: upper lower upper upper middle middle upper lower lower middle lower upper lower middle middle middle lower middle middle lower lower lower middle middle middle upper class
annewilliam: middle lower middle upper middle middle upper middle middle lower upper class
beaharry: lower upper lower upper lower middle upper middle middle upper middle lower upper middle upper middle lower middle class
carlabob: middle upper middle upper lower lower middle middle upper class
stanleyjack: middle middle upper lower upper lower middle middle upper middle lower lower middle upper middle lower upper lower upper upper lower upper middle upper middle upper upper class
wendykarl: upper lower upper lower middle lower upper lower upper upper lower lower upper upper lower upper middle lower middle lower lower class
violetdana: upper middle upper lower upper upper upper middle upper upper lower upper lower lower lower lower upper lower middle lower lower upper lower middle middle class
richarddeanna: middle lower middle middle lower upper middle lower lower upper lower middle lower class
karlstanley: lower lower middle upper upper lower lower lower middle upper lower middle upper upper upper middle middle middle upper lower lower lower lower upper lower class
luannbob: middle lower middle lower upper lower middle upper class
bobanne: lower lower middle upper upper middle upper lower lower lower lower class
patriciaanne: upper lower middle lower middle lower middle middle upper middle middle middle lower class
jeffwilliam: middle lower lower class
petermark: lower upper lower middle lower lower middle lower middle middle upper upper class
hanstommy: upper lower lower upper upper lower lower lower middle lower upper middle upper lower middle middle middle lower lower lower upper upper upper upper class
luanntom: lower upper upper upper middle lower upper lower lower lower lower lower upper middle upper lower lower middle upper class
wendymarian: lower class
annemark: middle lower lower middle middle middle middle lower lower upper upper upper middle middle middle lower upper middle middle lower lower upper lower lower upper lower upper class
maryharry: middle lower upper middle middle middle upper middle lower upper lower upper class
tommyed: upper middle lower upper middle middle lower lower upper upper lower class
carlsue: middle lower middle middle lower lower class
jeffrich: upper lower lower middle middle upper middle middle lower lower upper middle middle lower middle middle middle upper lower upper upper upper lower lower middle middle class
edcarla: upper middle lower middle lower lower middle lower upper middle upper middle middle upper upper upper middle middle lower lower upper class
mariancarla: upper lower middle middle middle upper lower middle middle upper upper middle lower lower middle middle upper class
deannajeff: lower middle upper upper middle upper lower middle upper upper middle middle lower middle upper lower lower lower class
markstan: lower middle lower lower upper lower upper lower upper middle middle upper middle lower middle upper upper middle middle class
carlmary: lower lower upper middle upper upper middle upper upper middle upper middle middle lower class
franzmarian: middle lower middle lower upper class
peterdavid: middle middle upper upper upper upper upper middle lower lower lower lower middle lower upper middle upper lower middle lower class
arnolddeanna: upper upper middle upper middle lower upper middle upper upper middle lower upper middle upper lower upper upper upper middle lower class
stanleyhans: upper upper lower middle upper upper middle class
davidfrank: upper upper lower upper lower upper middle lower lower class
billdavid: lower lower middle lower lower lower upper upper lower middle middle lower class
carlaharry: lower lower middle middle upper class
arnoldfranz: upper middle upper middle lower upper lower lower upper middle lower middle upper upper lower upper lower middle upper upper middle lower middle middle lower class
danaharry: middle lower upper middle middle lower upper lower middle lower middle upper upper middle upper lower lower middle lower lower upper upper class
jackwilliam: upper middle upper upper middle middle lower lower lower middle upper lower lower middle lower upper middle upper middle lower lower lower upper class
bobstanley: lower lower middle lower middle upper lower middle lower upper lower upper lower middle middle upper upper lower lower lower upper class
tombob: upper middle middle upper middle middle lower middle upper middle middle upper lower lower middle middle middle lower lower middle upper lower class
wendycarla: upper middle middle lower middle class
xaviertom: middle middle middle lower upper lower lower upper upper middle middle lower lower lower middle middle class
maryrichard: lower upper upper middle upper middle lower upper lower middle lower middle upper upper lower middle lower middle middle middle middle lower middle middle upper middle class
beafranz: upper middle lower upper lower middle upper upper lower upper middle lower upper upper lower lower class
xavierfrank: lower upper middle upper middle upper class
maryjose: upper lower upper lower upper lower upper middle upper lower middle class
marytommy: middle upper lower middle middle lower middle upper middle lower upper lower upper lower lower lower upper upper lower middle lower class
bobxavier: upper lower upper upper middle upper middle lower middle middle lower middle upper middle lower middle middle upper lower upper middle class
johnmary: upper lower upper middle lower middle middle middle lower upper middle middle upper lower middle class
williamcarla: lower upper middle upper upper lower upper upper middle upper middle lower middle upper middle middle upper upper upper middle upper class
hanshans: middle upper upper middle lower lower lower middle upper upper upper lower middle lower middle upper upper upper middle middle middle upper upper upper middle class
markjose: upper middle middle lower middle middle middle upper lower upper upper middle middle class
richjack: upper upper lower upper upper middle upper lower upper middle middle lower upper class
josetom: upper middle upper lower upper lower upper upper upper middle upper upper upper lower middle middle lower lower upper middle middle lower class
williambea: upper upper middle upper middle upper upper lower middle upper lower upper lower upper middle lower lower upper lower lower upper middle middle middle middle middle middle class
franzmona: lower middle middle upper middle lower lower middle middle upper upper middle upper middle upper class
franzbea: lower lower lower upper middle middle lower upper middle lower lower lower lower middle upper middle upper lower upper lower lower middle upper middle class
richardbob: upper middle lower lower lower middle middle lower middle lower middle middle class
jeffdick: upper lower upper upper middle middle lower upper middle middle lower middle upper class
patriciakarl: lower lower middle upper middle class
luannsue: lower middle middle middle lower lower upper middle middle middle upper upper upper upper upper lower class
peterbill: middle lower lower middle lower lower lower middle class
tomanne: middle upper class
wendyrick: lower upper lower middle upper upper lower upper upper class
jackmary: lower lower lower middle middle upper middle upper lower lower middle middle upper middle upper lower class
beajose: middle upper lower lower lower lower middle middle lower lower lower lower middle middle upper middle lower lower middle upper upper middle upper lower upper middle lower class
carlkarl: lower middle upper middle upper lower middle lower class
tommyanne: lower middle class
franzdeanna: lower middle upper upper upper lower upper lower lower upper middle middle middle middle upper upper upper middle lower upper lower middle upper lower class
johnharry: lower lower upper upper upper upper middle upper lower upper middle lower lower lower lower middle lower lower upper upper middle class
johnbill: middle middle lower middle lower lower lower middle upper middle middle middle upper lower middle middle upper lower class
monabill: lower middle middle upper middle lower middle lower lower middle lower middle middle middle middle lower upper lower middle class
beaarnold: lower upper lower lower upper lower lower middle upper middle class
richardviolet: middle lower upper middle middle middle upper middle upper upper lower middle lower upper lower upper middle lower middle lower middle upper middle middle class
tomrich: upper upper middle upper upper lower upper class
dickanne: upper upper lower upper lower class
jackanne: lower middle lower class
tommyxavier: middle lower lower upper upper lower middle lower middle lower upper middle upper lower lower lower lower middle upper middle class
beapati: middle upper upper upper upper middle middle middle upper lower middle middle lower middle class
billtom: middle middle upper lower upper middle middle upper upper lower middle lower middle lower lower lower class
wendytommy: upper lower lower middle lower upper lower lower lower middle lower lower upper middle upper upper class
rickfrank: lower middle middle middle middle middle lower upper lower lower lower middle lower upper middle upper middle middle lower lower lower upper upper class
richjohn: lower middle middle middle lower middle middle upper upper upper middle middle upper middle upper middle middle lower upper lower upper upper lower upper class
xavierviolet: upper middle class
deannabea: upper upper upper upper middle upper lower middle lower lower upper lower middle upper middle middle middle upper middle lower class
stancharles: middle lower lower lower lower middle lower lower upper middle upper upper upper middle middle lower middle upper lower lower upper middle middle lower upper middle class
luanndick: middle lower middle upper upper upper middle lower lower class
anneluann: upper upper middle upper lower upper upper middle middle upper lower lower upper lower lower class
marianrick: lower lower upper middle middle upper middle middle upper upper middle lower upper lower lower upper middle lower lower lower middle upper lower middle middle upper class
peteranne: middle middle upper middle upper middle upper upper lower lower lower lower middle upper upper middle middle lower middle middle lower lower class
beapatricia: upper upper middle middle upper class
luannarnold: middle upper upper middle middle lower upper lower upper middle class
billarnold: lower middle middle middle upper middle lower lower middle lower lower lower middle lower middle upper lower class
violettommy: lower class
arnoldstan: upper lower lower middle lower middle upper middle lower middle middle lower middle middle middle upper lower upper middle lower lower upper lower middle middle middle upper class
xaviermark: upper upper upper middle upper upper lower lower lower lower upper lower upper upper upper class
garydeanna: upper lower lower lower lower upper middle upper middle middle middle class
hanscarl: middle middle middle lower upper lower upper lower lower class
markmarian: lower middle lower upper class
marianmary: upper upper lower class
monicaarnold: upper middle upper lower middle lower lower class
josegary: middle lower lower upper middle lower lower lower middle lower upper middle lower lower upper class
carltom: middle middle lower upper upper upper middle middle lower middle upper middle upper lower lower middle lower upper lower upper upper lower upper class
richmarian: middle middle lower middle middle upper middle class
billmark: upper middle upper lower upper middle lower lower upper middle upper upper middle upper upper upper upper middle class
jeffbea: lower middle upper middle upper upper upper lower lower middle middle lower lower upper middle upper upper upper upper lower upper middle upper class
carlfranz: lower upper lower middle upper middle lower lower upper upper middle lower middle middle middle middle upper middle class
stanmark: middle middle lower lower lower lower upper middle upper upper upper middle upper lower middle middle middle class
franzanne: lower middle lower lower upper lower middle upper lower middle middle upper class
williamjohn: lower middle upper middle upper lower upper upper lower upper middle lower middle lower class
stanleybea: upper middle upper middle middle middle upper lower lower lower upper upper middle lower upper lower lower upper lower middle upper upper middle class
jackstanley: lower lower class
monicaxavier: lower lower upper middle upper upper lower middle middle upper upper upper middle upper class
carlhans: upper upper lower lower upper upper middle middle middle upper middle middle lower class
frankstanley: upper middle middle lower middle middle middle lower upper class
suemark: upper lower middle upper class
markfrank: middle middle middle lower lower upper middle upper lower upper lower lower lower upper upper lower lower lower lower upper lower lower lower middle class
beagary: middle class
arnoldbea: upper lower middle upper class
annerich: middle lower lower lower middle upper middle middle upper lower lower lower middle middle upper upper middle middle middle class
stanpeter: lower middle upper middle upper upper upper lower lower lower middle upper middle lower upper middle upper lower upper upper upper middle upper lower class
peterpatricia: middle class
richluann: upper lower upper middle upper middle lower upper middle upper middle lower upper middle lower class
frankwendy: upper upper lower middle middle middle lower middle lower upper upper middle upper middle class
deannaarnold: lower middle middle middle upper lower lower upper middle middle lower upper lower middle upper middle middle upper lower upper class
johncarla: upper upper lower upper middle upper lower lower upper lower middle lower upper middle middle lower upper class
arnoldtom: upper lower upper upper middle upper middle middle lower lower lower lower upper lower lower upper lower middle class
deannacharles: upper middle lower middle middle middle middle middle upper lower middle middle upper upper middle upper upper middle upper class
garypatricia: middle class
markkarl: middle upper lower middle upper lower lower lower upper middle lower lower upper upper upper middle middle upper class
monicafrank: middle lower lower upper middle lower upper middle middle middle lower upper upper lower middle middle class
patixavier: middle lower middle middle lower upper lower middle middle class
patriciaxavier: upper upper middle lower upper upper middle upper upper upper lower upper middle upper upper middle middle upper middle lower upper class
charlesstanley: lower upper upper upper lower lower middle lower lower middle middle middle middle middle middle lower middle lower upper upper lower lower lower upper middle lower lower class
hanskarl: lower middle upper upper middle class
patijeff: middle middle upper upper upper upper middle middle lower lower lower lower middle class
beapeter: middle upper middle lower middle upper middle upper middle upper middle lower lower upper class
tomfrank: middle upper upper upper middle middle upper upper middle upper middle upper middle middle lower middle upper middle upper upper middle upper lower lower class
anneed: middle lower upper upper middle lower middle upper upper lower middle upper middle upper upper lower lower lower lower lower middle class
beamark: lower lower lower upper middle upper middle upper lower middle lower lower upper lower class
luannmary: lower middle upper middle lower middle upper upper upper middle class
davidviolet: middle lower class
josestan: lower lower middle lower lower upper middle upper upper lower upper upper middle upper class
joseviolet: upper upper upper upper middle upper lower middle lower middle upper lower middle lower upper upper upper lower middle upper middle upper upper class
billcharles: middle middle upper lower lower lower middle middle lower class
arnoldbob: middle middle lower upper middle lower upper upper middle middle upper lower middle upper middle middle middle class
richardcarla: middle upper middle middle middle upper upper lower middle upper upper lower lower middle upper middle lower middle class
tommyhans: upper middle lower upper class
marybob: upper upper upper lower upper lower upper lower upper upper lower upper upper lower lower upper middle upper middle lower upper lower middle class
marysue: lower lower upper upper middle lower middle middle middle upper upper middle middle class
tommark: middle middle middle lower middle lower upper lower upper upper class
xavieranne: upper lower upper middle middle middle upper upper upper middle middle upper middle lower middle class
beastanley: upper lower middle upper middle lower lower upper upper upper upper upper lower middle lower class
patimary: middle middle middle upper middle upper lower middle upper upper upper middle middle lower middle middle lower lower middle upper upper lower lower class
richardtommy: lower lower middle middle upper lower lower upper class
monicahans: upper class
carlluann: middle middle lower middle lower middle lower middle middle upper upper lower lower middle middle middle lower middle lower upper lower middle upper middle upper upper upper class
frankmarian: lower upper upper lower middle lower middle lower upper upper lower upper upper upper lower class
jeffmonica: upper upper lower middle class
tommytom: upper upper middle upper upper upper class
patikarl: lower lower lower middle lower upper middle lower middle middle upper lower upper lower lower middle class
danamonica: middle lower upper middle middle lower upper middle class
stanleyarnold: lower lower lower middle lower upper upper upper middle middle upper lower middle lower upper lower class
richsue: middle lower upper lower upper middle lower middle lower lower upper upper lower upper upper middle middle class
marianjose: lower upper upper upper upper lower middle upper middle middle lower middle upper upper upper upper middle lower middle upper middle lower middle upper middle upper upper class
harrykarl: middle upper lower upper upper lower middle upper lower upper lower lower upper upper middle middle class
stanleyrichard: middle middle lower middle upper upper lower lower middle lower lower lower lower lower lower upper lower upper lower lower middle upper middle middle upper class
carlacarl: middle lower lower lower upper upper middle middle middle upper upper middle upper middle upper middle lower upper middle upper upper class
markharry: middle upper middle upper lower upper lower lower middle lower lower lower middle upper class
violetjack: middle upper middle upper middle middle lower lower upper middle lower lower lower upper middle lower middle lower middle upper middle lower middle lower upper class
monicagary: upper lower upper upper lower middle lower middle lower upper class
stanleyfrank: lower upper upper middle upper upper middle upper upper lower upper lower lower upper upper class
franzmary: upper middle upper lower middle middle upper upper middle upper upper lower class
frankfrank: upper lower middle middle upper middle upper lower upper class
stanleypeter: middle lower middle upper upper lower upper middle class
jackcarla: middle lower lower middle upper upper upper upper lower upper upper middle lower middle upper lower upper upper lower class
maryjack: lower upper middle middle upper upper upper upper lower lower middle lower middle upper upper upper upper upper middle lower lower middle lower upper middle lower class
frankgary: lower upper upper upper middle lower lower upper class
richardanne: lower middle lower upper class
jeffdana: middle middle lower upper lower lower middle lower lower class
garymary: upper upper upper lower middle upper middle middle upper middle upper lower lower lower upper upper lower upper middle upper upper middle class
danagary: lower lower middle upper upper middle lower middle upper upper middle lower lower lower upper lower class
luannpati: upper upper upper middle upper middle lower upper upper class
xaviermona: lower middle middle upper middle upper lower lower middle upper lower upper upper middle middle upper upper upper upper lower middle middle middle upper lower lower lower class
anneviolet: middle lower upper lower middle upper middle middle upper lower middle upper class
johnjohn: lower upper upper lower upper upper upper class
karlpeter: lower middle middle lower upper lower upper lower lower middle upper middle class
stansue: middle upper middle middle upper lower middle lower middle upper lower middle lower lower upper middle lower upper upper lower lower middle middle upper upper class
mariandeanna: middle upper upper middle lower upper lower lower lower middle upper lower upper lower upper lower class
patriciacarla: upper upper middle lower lower upper middle middle class
garyrichard: upper middle upper lower middle lower middle upper lower class
violetdavid: upper lower upper lower middle middle upper class
stankarl: middle lower middle lower lower middle middle middle lower middle class
billkarl: lower upper lower upper middle upper middle lower upper class
wendyfrank: upper middle upper lower upper upper middle upper middle lower middle lower upper upper middle lower upper upper middle upper upper upper lower middle middle middle class
edjohn: middle upper lower middle class
jeffkarl: lower lower middle upper upper upper middle upper lower middle upper upper lower lower middle lower lower lower upper class
patiarnold: middle upper lower middle upper lower lower lower lower middle middle lower lower class
suemona: middle middle middle middle middle upper lower middle lower upper middle lower lower upper lower middle upper middle middle class
franzwendy: upper lower upper middle upper middle upper upper upper upper class
tomviolet: upper lower upper lower middle middle upper middle middle middle lower middle upper lower middle lower lower upper lower upper upper middle middle middle lower upper class
xavierkarl: upper upper middle lower middle middle middle lower class
marymona: lower upper lower lower middle upper middle middle middle middle upper upper middle lower lower lower upper upper lower lower upper middle middle middle upper class
monamark: middle lower upper lower lower lower lower upper lower middle lower middle lower upper upper lower lower middle middle middle middle middle lower class
hansdavid: lower upper upper middle middle lower lower lower upper middle upper upper middle upper upper middle lower lower upper upper class
charlespeter: upper upper upper upper middle upper upper upper upper middle class
karlrick: middle lower upper upper lower upper class
violetjohn: upper upper lower middle upper middle lower upper lower upper middle upper class
monastanley: upper middle middle upper upper lower class
carlcarla: upper middle class
xaviertommy: lower lower upper upper upper lower lower lower middle middle middle upper lower lower upper upper middle middle middle lower upper lower lower middle middle class
tompati: lower middle middle lower lower lower middle middle lower lower middle middle upper upper class
deannaluann: middle upper upper middle upper upper middle middle upper lower middle lower upper middle lower lower middle upper upper middle lower upper lower class
violetrick: upper upper lower middle middle lower upper upper upper lower upper lower upper upper class
ricked: lower class
jackjeff: lower upper upper lower upper middle middle upper middle upper upper upper middle middle upper middle lower upper lower upper class
violetwendy: middle middle lower lower lower middle middle upper lower upper lower upper upper lower lower lower lower upper middle class
billdick: lower lower lower middle upper middle lower upper lower class
karltommy: middle lower upper middle upper lower middle lower lower upper upper upper middle middle lower middle lower lower lower lower lower middle upper middle middle class
williamrick: lower lower upper upper middle upper middle lower middle upper upper lower lower middle class
tommybob: middle middle middle upper middle lower lower middle middle upper class
monicafranz: upper lower lower upper lower middle lower lower lower middle middle upper class
marktommy: middle upper middle lower lower upper lower lower upper lower lower upper middle middle middle middle middle lower upper middle lower middle lower class
markjack: upper lower middle upper middle class
tomdeanna: middle lower middle upper upper upper class
karlkarl: upper lower middle upper upper upper lower lower lower middle middle upper upper middle class
monicabob: middle middle middle lower lower middle lower upper upper class
danajose: lower lower middle lower class
markpeter: middle upper upper middle lower middle lower upper middle middle upper upper upper upper upper upper middle class
davidgary: middle lower upper upper lower upper upper class
deannamark: upper lower lower middle lower upper upper lower upper lower upper middle lower lower lower middle upper upper class
billpatricia: lower middle lower lower lower middle upper middle lower lower lower upper lower middle lower middle middle class
deannagary: lower lower middle lower middle lower lower middle middle lower middle lower upper lower lower upper upper upper middle lower middle middle lower lower class
carlfrank: lower lower middle lower class
edwilliam: lower class
dickrich: upper upper upper middle middle lower lower middle middle lower lower lower upper lower upper middle upper upper middle lower middle middle upper lower middle lower lower class
ricktommy: middle upper middle upper upper lower middle middle upper middle upper lower lower upper upper middle middle middle lower lower class
carlafrank: middle upper class
tommymary: lower upper upper upper lower middle middle upper middle middle middle lower upper upper middle upper class
edmarian: middle class
deannastanley: lower lower middle middle upper upper lower class
violetcarla: middle upper middle class
patibill: upper class
tompatricia: upper lower lower upper upper upper upper upper upper upper lower lower middle upper lower lower lower upper class
garymarian: middle lower middle middle middle middle lower upper middle lower lower middle lower middle upper upper lower middle middle lower upper upper upper upper upper upper class
suepeter: upper upper middle lower lower lower lower lower lower middle upper class
deannadick: middle lower upper lower lower lower middle middle upper class
tommyluann: middle upper upper middle upper lower upper lower lower lower middle upper upper upper lower class
tomcarla: lower middle lower upper lower upper lower upper lower lower middle lower upper upper middle lower lower upper upper middle class
patitom: lower lower lower middle upper lower lower upper middle lower middle lower middle lower lower middle middle middle lower class
johntommy: middle upper middle upper lower class
monicaed: lower upper upper middle middle upper middle middle lower middle lower upper middle upper upper middle middle upper lower middle upper lower lower lower middle lower upper class
dickviolet: middle lower middle lower upper lower middle middle upper lower upper class
richardjohn: lower lower middle middle lower upper middle lower lower middle middle lower middle middle lower upper upper middle class
edstan: lower middle lower middle middle middle middle upper middle upper lower middle class
wendystanley: lower middle upper upper lower lower middle lower middle lower upper upper middle class
richstan: middle upper upper upper class
harryrick: middle lower class
xavierpatricia: upper upper upper upper class
richrick: upper upper lower upper upper upper middle middle lower lower upper upper middle middle upper upper lower middle lower upper class
violethans: middle lower middle middle lower class
johnfranz: middle upper lower middle middle middle class
mariandana: lower lower middle middle upper lower upper middle middle upper middle upper middle lower upper class
dickjack: middle upper upper lower middle upper upper upper upper lower upper lower class
marytom: lower lower lower upper upper lower lower lower upper middle middle upper class
danajeff: lower lower middle middle upper upper lower lower upper upper upper lower upper upper lower upper lower upper class
violetdeanna: lower middle upper middle lower lower upper lower upper middle middle lower class
edpati: lower middle middle upper class
hansanne: lower lower lower middle upper class
deannaxavier: lower upper middle middle upper middle middle middle upper upper lower upper middle lower middle lower middle lower middle lower middle upper class
deannajose: upper upper middle middle upper middle middle lower middle upper lower upper lower middle upper lower class
hansdick: upper middle middle lower upper lower class
stanbill: lower middle upper upper upper upper middle lower lower lower upper middle lower upper upper lower lower middle upper lower class
monadana: upper class
harrytom: upper middle upper upper middle upper upper lower middle lower middle class
franzrick: lower upper upper upper middle lower lower upper class
williamfranz: lower lower lower lower middle middle upper middle lower upper middle middle lower upper lower upper lower class
marycarl: upper lower class
maryjeff: middle middle middle lower lower middle upper middle lower middle middle middle middle middle lower class
charlestom: upper upper class
davidxavier: lower middle upper upper middle upper upper upper lower upper middle class
wendyjohn: lower middle middle upper upper upper upper lower upper upper upper middle middle upper middle class
stanleyxavier: middle middle upper class
hanscarla: upper middle middle class
patriciagary: upper lower upper middle middle lower upper class
xavierjack: middle middle lower lower middle class
violetluann: upper lower lower upper lower middle lower middle middle lower upper middle middle lower lower upper lower lower middle middle upper upper class
carlgary: upper upper middle upper lower lower lower lower lower lower upper upper lower upper upper lower upper upper middle upper lower lower middle class
carlaarnold: upper upper lower lower middle middle middle upper upper upper upper lower upper lower middle middle lower class
tomsue: upper upper middle middle upper middle middle lower middle lower middle middle lower upper upper lower middle upper middle upper middle middle lower lower class
carlakarl: middle middle middle upper lower upper middle lower upper middle middle middle middle lower upper lower upper upper upper middle middle middle upper lower class
carlapeter: upper lower lower lower upper upper lower lower middle middle upper class
richardluann: middle upper lower middle lower lower upper middle middle lower middle middle lower middle upper middle lower lower upper middle class
stanleystan: lower upper middle lower upper upper upper class
peterarnold: upper middle class
williamwendy: lower upper middle upper middle lower lower lower middle lower middle middle lower class
peterpati: middle middle upper middle middle middle middle upper middle middle middle upper upper middle upper upper lower upper upper class
patifranz: middle upper upper middle class
suearnold: middle middle middle upper upper upper lower middle upper upper class
marked: upper lower lower lower middle upper lower lower middle upper lower middle middle middle lower middle middle lower class
sueharry: upper lower middle middle lower middle upper class
karljeff: upper upper middle upper lower class
charlesmonica: middle upper lower lower upper lower class
garyrich: lower upper middle lower lower upper class
jeffanne: middle upper lower lower class
carlasue: upper upper upper middle upper lower upper middle lower lower upper upper upper lower middle lower lower lower lower middle middle middle middle middle lower lower class
xavierxavier: upper lower lower lower middle lower upper middle lower middle lower class
annejack: middle class
davidrichard: middle middle middle middle class
annemona: middle middle class
jeffmark: middle upper lower middle lower lower upper middle upper middle class
davidanne: lower upper upper lower lower middle upper lower middle upper upper middle lower upper middle middle upper upper middle upper class
richardfranz: middle lower upper middle class
richmona: middle middle lower lower lower lower middle class
dickcarl: lower middle middle upper class
franzcarla: lower lower lower upper middle lower lower middle lower upper middle middle upper lower class
harrybea: middle class
marianrich: lower lower middle lower upper middle middle lower middle upper upper upper lower class
deannadeanna: lower upper upper middle lower upper upper upper upper upper middle upper lower lower class
luanndana: middle middle middle lower upper lower middle upper middle upper lower upper upper upper lower upper middle middle middle class
maryfrank: middle middle upper upper class
hansstan: middle middle class
charlesrich: upper upper upper middle lower middle lower lower upper lower lower lower lower upper middle middle upper class
harrysue: lower lower middle lower upper upper middle lower lower lower lower middle upper lower lower upper upper upper upper lower lower middle lower middle upper lower class
wendydana: lower upper lower lower upper upper middle middle upper upper lower middle lower upper lower upper upper lower upper upper upper class
deannapatricia: lower upper lower lower upper lower upper upper lower upper middle lower upper lower lower upper lower middle lower upper middle upper lower upper class
josebea: lower upper middle upper upper upper lower middle lower class
annerichard: lower upper upper upper lower middle upper upper upper upper upper lower lower lower middle lower lower class
beacharles: lower lower class
frankpati: upper lower lower lower lower upper upper middle middle middle upper lower lower lower middle lower upper middle middle upper upper lower middle lower upper upper lower class
rickrichard: upper lower lower upper upper middle lower middle upper middle upper upper upper upper lower lower class
monicajose: upper upper lower lower middle upper lower middle lower lower lower middle lower middle middle middle upper upper middle middle upper upper class
williammary: middle lower upper middle middle lower lower class
marianjeff: lower upper middle class
edpeter: lower middle middle upper middle upper upper class
stanleywendy: middle upper class
suesue: middle lower lower middle upper upper upper middle upper lower upper upper middle lower upper middle middle middle middle lower lower upper upper lower class
stanpati: lower middle middle lower middle middle upper lower lower upper upper middle lower upper middle upper upper middle lower middle upper middle upper class
josecharles: lower upper upper upper middle middle upper lower middle upper middle middle middle lower middle lower class
suepatricia: middle upper middle lower upper lower lower lower class
monicatom: middle upper upper lower lower upper upper lower middle middle lower middle upper lower lower upper lower lower lower middle lower lower middle upper upper lower lower class
charlesjeff: middle upper middle lower lower middle upper lower middle upper middle lower middle lower upper middle upper upper middle lower middle class
dickstan: upper upper middle lower upper middle lower upper upper middle lower middle upper upper lower middle middle lower lower upper middle upper middle class
richmonica: upper middle upper middle lower upper lower upper lower middle middle lower upper upper lower middle upper upper lower lower lower class
danadana: upper middle lower upper middle middle middle class
marianmarian: lower lower middle upper middle lower upper upper upper upper middle middle class
violetfrank: middle lower lower upper middle lower middle upper middle lower middle upper middle middle class
harryxavier: lower lower middle upper upper middle lower middle lower lower lower lower lower middle lower lower lower lower middle lower upper middle class
