1000
deannafrank: upper class
carlafrank: middle middle lower upper upper middle lower upper upper upper middle middle middle middle upper upper lower middle middle middle upper middle middle upper class
bobgary: middle lower middle upper middle class
arnoldbea: lower upper upper middle middle upper upper upper upper lower lower middle upper middle class
davidjack: upper lower lower lower middle middle lower middle lower class
frankmonica: upper lower middle middle upper class
monicastanley: lower middle upper upper upper middle upper lower middle lower middle middle upper middle upper upper upper lower upper middle upper upper middle middle class
suegary: lower middle middle upper lower lower middle lower upper upper lower lower middle lower upper middle middle upper class
hanswendy: upper middle lower upper lower lower upper upper upper middle middle lower upper lower class
richardpati: upper middle upper upper middle lower lower lower lower upper middle middle middle upper lower lower middle lower upper upper class
patriciaanne: middle lower upper lower middle lower lower upper lower lower upper middle lower upper class
marydavid: upper upper lower upper lower upper middle middle lower lower middle middle lower middle upper middle middle upper upper upper lower class
monicastan: middle upper class
stantom: lower lower middle upper middle lower upper lower upper lower lower middle upper lower middle lower lower middle middle lower middle lower upper middle middle upper class
carlkarl: lower upper upper middle middle upper upper upper lower lower middle upper lower lower upper lower class
violetcarla: upper upper class
tombill: middle middle middle lower upper lower lower lower lower upper middle upper lower lower upper upper middle lower upper upper class
stanjohn: upper upper upper upper middle class
markpati: lower lower upper lower middle upper upper middle middle upper middle middle lower middle middle middle middle lower lower upper upper class
franzstan: middle lower lower upper middle middle class
carlfranz: upper upper upper upper middle lower upper lower lower upper lower upper upper upper lower middle upper middle middle upper lower lower middle upper middle upper class
patianne: lower upper upper lower middle upper middle upper upper lower upper middle upper lower upper lower upper upper upper lower class
carlaviolet: lower upper class
harrydana: lower middle lower class
garyrich: lower class
hansgary: upper upper upper middle upper lower upper lower upper upper middle lower lower lower lower lower middle middle upper lower middle lower middle upper upper upper class
monajohn: lower lower lower upper upper upper middle upper middle upper lower middle lower middle middle middle upper upper upper upper middle upper upper middle middle class
charlesgary: lower lower upper middle upper upper lower middle middle lower lower lower class
carlstan: lower middle middle lower upper upper upper middle lower middle lower middle upper middle lower lower upper lower middle class
suecarl: lower lower lower lower lower middle upper lower middle middle middle upper upper middle lower middle upper lower middle class
jefftom: upper lower middle lower middle middle upper upper class
josedavid: upper lower upper middle upper upper upper upper middle upper upper upper lower middle upper class
wendyharry: lower upper middle upper upper middle middle middle upper middle lower lower middle lower middle middle lower lower upper lower lower upper lower upper middle upper upper class
marybill: upper middle upper lower upper middle middle lower lower middle middle middle lower upper upper upper upper upper upper upper middle lower middle class
tommyjose: upper middle lower upper middle lower middle upper upper middle lower middle upper upper class
stanjeff: upper lower upper upper upper upper middle lower middle upper upper middle class
patistan: upper upper lower upper middle upper upper lower upper upper class
edpatricia: upper middle middle middle middle middle upper lower middle lower middle class
danamona: lower lower upper middle upper upper middle middle upper lower upper middle lower upper upper upper middle upper middle middle lower class
patiluann: lower upper lower middle lower upper upper middle class
stanleydana: upper lower middle upper middle middle middle middle upper lower upper middle middle middle lower upper upper middle lower middle upper upper lower upper upper class
davidanne: lower upper lower upper lower middle lower middle upper upper upper upper lower middle class
davidpatricia: upper upper upper upper class
garydick: upper lower upper upper lower upper middle upper middle lower middle lower lower middle upper upper middle upper upper lower middle lower class
danaarnold: middle middle upper lower middle upper middle middle upper upper middle lower lower lower lower upper middle middle upper lower lower middle lower lower upper upper lower class
charlescarl: upper upper class
karljack: upper lower middle middle upper lower class
monamonica: middle middle middle upper class
bobed: middle middle lower lower lower lower lower upper middle lower middle class
bobxavier: middle lower upper lower lower middle lower upper middle middle upper lower middle middle upper middle upper lower middle lower middle middle lower middle middle class
richardhans: lower middle lower middle upper upper lower upper lower class
dickkarl: middle lower middle upper upper class
frankwendy: upper upper upper middle middle lower upper middle lower upper lower lower upper lower middle upper upper middle middle upper class
danaviolet: upper middle lower middle middle upper middle middle lower lower upper middle lower upper lower class
davidharry: lower lower middle upper middle middle upper middle upper lower middle upper middle upper lower middle middle middle upper lower lower middle middle lower class
monicamark: lower middle upper lower upper middle class
tommycarl: upper upper lower upper middle lower class
charlessue: middle upper upper lower middle lower lower lower lower upper upper upper lower upper lower lower upper lower lower upper upper middle middle class
harryjeff: middle lower class
charlesmona: lower lower upper lower middle middle upper middle upper middle upper middle upper lower middle class
marianfranz: middle upper upper lower lower upper upper upper upper upper middle middle lower upper upper middle middle class
violetcharles: upper lower upper lower lower lower upper middle class
suemary: lower lower middle lower upper middle middle upper middle lower upper middle middle upper middle class
edstan: lower lower upper middle lower middle lower middle middle upper upper middle lower upper lower upper middle lower upper class
marianhans: middle lower upper upper upper lower lower middle upper class
xavierluann: upper upper lower upper lower upper upper middle middle lower class
xavierbob: middle lower upper lower lower middle upper lower middle lower lower upper lower middle class
davidgary: upper upper middle middle middle middle upper lower lower upper lower middle lower upper middle lower lower upper middle upper middle upper upper upper class
dickjohn: upper middle middle upper middle lower lower lower upper lower lower lower upper middle lower lower middle upper upper class
harryharry: upper upper upper lower upper lower lower middle middle upper middle middle class
monadavid: lower lower middle upper middle upper middle middle lower upper lower upper middle middle class
xaviermarian: upper middle upper lower lower lower upper middle upper lower lower lower lower upper lower middle lower upper middle middle middle upper class
josefrank: lower upper upper middle lower lower class
dicktom: middle middle upper class
patriciaviolet: lower middle middle upper upper class
mariancarl: lower upper middle class
monicarich: lower lower middle upper upper lower upper middle upper lower upper middle upper middle class
danarick: middle middle upper lower lower upper lower class
hansfrank: middle lower class
tommystan: upper class
violetmarian: middle middle lower middle middle middle upper lower middle upper lower upper upper lower lower lower middle middle upper upper middle middle class
dickdavid: upper lower middle middle lower lower middle upper upper upper upper middle middle middle middle middle lower lower class
tommyfrank: lower lower upper upper upper middle upper middle upper middle lower upper middle middle middle lower middle lower lower upper class
tommydeanna: upper middle middle lower class
tommydana: lower middle lower lower middle upper middle upper class
edfrank: lower upper middle middle middle upper upper lower middle lower middle upper upper lower lower lower upper upper class
petermarian: upper upper middle middle lower lower upper lower middle lower middle middle middle middle lower lower middle lower upper upper upper middle upper upper class
patriciaxavier: lower class
patriciamonica: middle upper middle lower middle upper middle middle lower middle lower lower middle middle lower middle upper lower upper upper lower upper middle lower class
richcarla: upper class
harrymary: upper upper lower class
garyharry: upper lower upper lower middle upper middle middle lower middle middle middle lower upper lower class
wendycharles: lower middle lower middle middle lower middle middle lower lower lower middle middle upper upper lower middle upper middle upper lower middle upper upper class
violetjack: lower lower lower lower lower middle lower upper middle upper class
williamviolet: upper middle upper middle lower middle middle upper lower middle upper lower lower middle class
monicabob: upper middle middle upper middle upper lower lower lower lower middle middle middle middle upper upper upper upper upper upper class
garytom: lower middle lower lower middle upper middle lower middle lower middle middle lower class
beabea: middle upper middle upper middle upper lower middle lower lower lower upper class
josedeanna: lower middle middle upper middle upper upper middle lower upper middle middle upper upper middle middle upper upper upper lower lower upper lower middle class
annesue: upper upper upper upper class
bobcharles: lower upper lower upper upper lower lower lower lower middle class
franzmarian: upper middle middle upper lower lower lower middle upper middle middle upper middle middle upper class
patisue: middle lower lower middle upper upper lower upper upper lower middle middle middle lower upper lower lower upper upper lower middle middle upper class
jackmark: middle middle lower middle lower upper middle class
stanleygary: middle upper middle middle upper middle upper upper middle upper lower upper upper lower upper upper lower middle middle class
richsue: lower middle lower middle lower upper lower middle upper upper upper upper lower lower class
franzjohn: lower upper middle upper lower middle middle upper upper middle middle upper class
marksue: lower middle upper middle middle middle upper middle upper lower middle lower class
edkarl: upper upper upper lower upper middle lower middle middle lower middle middle middle upper lower middle middle class
jeffanne: middle middle upper upper upper middle middle lower lower upper class
luannwilliam: middle middle upper upper middle middle middle middle upper upper lower middle upper middle lower middle lower middle lower lower lower lower lower middle middle upper lower class
carltommy: middle lower upper lower upper upper upper middle lower lower lower middle lower middle upper class
beacharles: lower middle middle upper middle middle middle middle upper lower upper lower lower lower middle upper lower middle lower upper upper lower lower upper middle upper upper class
ricked: lower lower lower upper middle upper upper middle lower class
davidjose: upper middle middle class
patixavier: lower lower middle lower lower lower lower middle lower middle upper class
wendyfranz: lower middle upper middle middle lower middle lower lower middle middle upper upper middle upper upper lower upper middle upper lower middle lower upper middle lower class
danadavid: upper upper middle upper middle middle upper middle middle lower lower upper lower middle middle lower upper lower upper middle middle middle upper lower lower class
edstanley: upper lower lower middle upper lower upper upper lower middle middle upper upper lower lower lower middle class
carljeff: lower middle lower middle upper lower upper lower lower lower upper lower middle middle lower upper upper lower middle upper class
annekarl: middle upper middle upper upper middle class
carlabea: upper middle upper upper lower middle lower upper class
billgary: lower lower lower upper lower upper class
joseharry: middle class
richharry: middle middle middle lower upper middle upper lower upper class
danacarl: upper middle upper lower upper upper lower upper upper class
jeffviolet: lower class
deannadeanna: middle middle upper lower upper lower middle lower upper middle upper lower upper middle upper middle upper lower upper class
patistanley: lower lower lower middle middle upper middle upper lower lower upper class
tomviolet: middle upper middle middle class
billmary: upper upper middle lower middle middle upper upper middle upper middle middle middle lower lower lower middle upper middle lower class
davidmary: upper middle middle middle middle lower lower middle middle middle class
williamarnold: upper upper lower middle lower upper middle lower upper middle middle middle middle middle lower middle upper upper lower class
patimona: middle middle lower upper upper middle upper upper upper upper lower lower middle middle lower lower lower middle middle upper middle upper lower upper class
johnpeter: upper middle lower lower class
harrycharles: upper middle upper middle middle lower lower upper middle middle upper middle middle middle class
edwilliam: middle upper upper upper lower upper upper upper middle middle upper upper upper middle upper lower upper upper lower upper middle middle class
monicapatricia: upper middle middle upper lower middle upper middle upper upper upper upper upper upper class
monarichard: lower middle lower middle middle lower lower middle upper middle upper upper middle upper middle middle lower middle middle upper class
stanleyluann: lower lower lower lower middle middle middle lower upper lower middle upper lower lower middle middle lower lower class
violetbea: middle class
franztommy: upper middle lower lower upper upper middle lower lower upper upper middle upper upper upper middle middle lower upper upper upper class
xavierrich: lower middle upper middle upper middle lower upper lower middle upper lower upper lower middle upper upper middle lower class
monarick: middle lower upper lower upper lower middle upper upper middle middle middle class
patriciastanley: upper middle lower middle middle middle upper lower lower lower upper lower upper upper lower middle middle lower lower middle lower middle upper class
garydana: middle middle class
edluann: middle middle middle middle upper upper middle upper middle middle middle lower lower lower lower class
wendyjohn: upper lower lower upper middle middle middle upper middle middle lower middle middle upper lower class
johncarla: middle middle middle lower middle lower middle upper lower lower middle lower lower lower middle lower middle middle middle upper middle lower upper upper middle lower lower class
frankmarian: middle class
carldick: lower lower middle upper upper middle middle lower upper lower upper middle middle middle upper lower lower upper upper lower lower class
karlanne: middle lower lower middle lower upper lower lower upper middle upper lower upper lower middle middle lower upper middle lower lower middle lower class
josefranz: upper upper middle middle upper lower upper middle middle class
tomtommy: middle middle lower upper lower lower upper upper lower upper upper middle middle lower lower upper lower lower lower upper lower lower upper middle upper class
bobmark: middle upper class
beapati: lower middle middle middle middle upper upper upper lower upper upper lower middle middle lower middle upper middle middle lower upper class
jackluann: middle upper lower middle middle upper middle upper middle upper middle upper upper upper upper upper upper upper class
frankmark: lower upper upper lower upper upper lower lower upper upper upper lower middle lower class
tomharry: upper upper upper upper lower middle upper upper middle lower lower lower class
monacarl: upper lower upper middle lower middle lower lower middle lower upper upper lower upper lower lower middle upper upper upper upper upper middle upper class
carlaxavier: upper upper middle upper upper class
violettom: lower lower upper lower upper lower upper middle lower middle lower lower upper upper lower class
luannmona: lower class
wendyfrank: middle upper upper lower middle middle middle upper lower middle middle lower lower lower upper lower class
garyarnold: upper middle upper upper upper middle middle middle upper upper middle upper upper lower middle upper lower middle upper upper upper middle class
johnmarian: upper middle middle upper middle class
markdana: lower middle lower upper lower lower upper upper middle middle lower lower middle middle middle upper middle upper lower upper lower middle middle lower middle class
hansed: lower lower lower lower middle upper middle middle upper lower lower upper class
marytommy: middle upper lower lower upper upper middle lower middle upper middle lower upper middle lower upper lower upper lower class
rickhans: upper upper upper middle upper middle middle middle middle lower middle middle middle lower upper middle class
johnjohn: lower upper lower middle middle upper lower middle upper upper lower upper middle lower upper middle lower upper middle middle upper class
maryrick: middle middle upper middle middle class
marianjack: upper middle upper lower upper upper middle lower lower upper middle upper middle middle upper middle lower middle upper lower upper lower middle class
beafranz: lower lower middle upper lower middle upper upper upper upper upper lower lower upper middle middle middle upper middle lower lower lower class
karlwendy: upper lower middle upper upper middle lower lower lower upper middle lower lower lower lower middle lower middle middle upper upper lower middle class
edfranz: upper class
richardfranz: middle middle upper middle upper lower upper lower lower lower middle middle lower lower lower middle lower middle lower upper lower middle upper upper lower lower class
marytom: lower lower middle middle lower upper middle upper upper lower lower middle lower upper middle middle middle lower upper class
deannajohn: lower lower lower lower lower lower middle middle middle upper lower upper upper upper lower lower upper upper upper upper middle lower lower class
markhans: middle lower lower upper lower upper middle upper upper upper upper lower upper lower middle upper class
tomhans: lower upper lower middle lower upper lower lower middle lower class
stanmary: upper lower upper middle upper upper upper middle middle lower upper lower class
edrichard: middle middle lower lower upper lower lower lower upper upper middle middle lower middle upper middle middle middle middle upper upper lower middle middle class
carlajose: upper upper lower lower middle lower upper middle upper upper upper middle lower middle upper middle middle upper lower lower class
josedana: lower lower upper middle upper lower lower middle middle middle lower lower lower middle upper lower upper lower class
stanleyjose: upper lower lower upper middle upper middle class
beamary: upper upper lower lower lower upper middle upper upper upper middle lower middle middle upper upper upper middle middle lower upper lower middle middle upper class
monicasue: middle middle lower upper lower middle upper class
franzmark: lower lower middle upper middle upper lower class
carldeanna: upper class
johnmonica: middle upper lower lower upper middle upper middle upper upper middle lower middle upper upper middle lower lower lower middle class
charlesfrank: upper upper lower middle lower upper upper middle upper middle lower middle lower lower upper upper class
annexavier: middle lower lower upper lower upper middle upper lower lower lower lower lower middle middle lower lower middle upper lower middle upper lower middle class
annepati: lower middle lower upper lower lower lower lower middle lower lower lower upper lower lower lower upper upper lower middle upper middle lower upper class
carlaed: upper middle middle middle upper upper lower lower lower middle upper upper lower middle lower class
davidsue: lower lower upper middle middle upper middle upper lower lower upper middle upper class
franztom: upper lower upper lower middle middle upper middle lower upper lower upper upper lower upper middle middle lower middle middle lower upper class
monajose: middle middle middle middle lower middle lower lower upper middle middle lower upper middle lower upper lower middle lower middle class
davidkarl: upper middle upper middle lower upper lower lower lower middle middle middle middle upper middle upper class
carlarick: upper middle lower upper middle middle upper middle middle lower upper upper lower class
marymary: lower lower upper lower lower upper upper middle lower lower middle upper upper class
eddana: middle lower upper upper upper middle middle upper middle lower middle lower lower middle upper middle upper class
arnoldmonica: lower middle lower middle upper upper upper upper lower middle lower upper class
charlesbob: upper lower lower upper middle middle upper upper lower middle upper middle middle upper upper middle lower upper lower upper lower class
billjose: upper lower middle upper middle middle lower lower middle middle middle middle upper upper lower lower middle lower upper class
violetmary: middle middle lower middle lower middle lower upper middle middle upper middle lower lower middle lower lower middle class
harryrick: upper lower class
luannjeff: lower class
jackfranz: lower middle lower upper middle upper middle upper middle class
violetsue: lower upper upper lower upper lower lower upper lower lower lower lower upper upper upper lower middle middle middle upper lower upper middle middle upper upper class
danapeter: middle lower middle middle upper middle middle middle upper middle class
monatommy: middle lower lower upper lower lower lower lower lower class
charlesdana: middle upper lower upper lower lower middle upper middle upper class
danacarla: middle middle middle middle lower upper lower middle lower middle middle class
beahans: upper upper upper middle middle upper middle class
carlluann: lower lower lower middle middle lower middle middle class
billrichard: lower lower lower lower upper lower lower upper lower lower upper middle lower lower lower middle lower upper class
johnluann: middle upper middle upper middle upper middle class
peterbill: lower middle middle middle lower middle upper upper lower lower class
bobbea: middle middle lower lower lower middle lower upper middle middle upper middle upper middle upper lower upper upper class
hansanne: middle middle upper lower lower middle middle upper upper class
stanleywilliam: middle lower lower middle lower middle upper upper upper upper lower lower upper upper middle lower upper lower lower middle lower upper middle lower lower middle class
carlaluann: lower upper middle middle upper lower lower middle middle class
bobanne: upper middle class
monicabea: lower middle upper middle middle upper upper upper upper class
annecarl: upper middle middle upper upper upper upper upper middle upper upper upper middle lower middle upper lower middle class
patriciatom: upper upper upper middle middle middle upper lower middle middle upper middle upper lower lower middle middle middle upper middle upper lower upper lower middle lower upper class
dickmark: upper lower lower middle upper lower lower middle middle lower middle upper class
josewilliam: middle upper lower middle middle upper class
edviolet: upper middle upper middle middle middle class
edmonica: middle upper middle upper middle middle lower class
richjohn: upper middle lower middle upper upper middle lower middle upper lower middle class
edjose: middle lower middle upper lower lower upper class
jeffmona: lower upper upper upper middle middle upper upper class
deannawendy: lower middle lower upper middle upper lower upper upper middle upper middle middle lower upper lower class
suestan: upper middle upper middle middle lower upper upper middle upper middle upper middle lower lower lower lower upper upper lower lower middle middle middle middle lower upper class
harryrich: upper lower lower middle middle upper middle lower lower upper lower lower middle upper upper lower upper middle class
beajeff: lower class
maryarnold: middle middle lower lower class
charlesdavid: upper middle lower middle middle lower lower middle middle middle lower lower middle class
rickpatricia: upper middle upper middle lower lower upper class
marygary: lower lower upper lower upper lower lower middle lower upper middle lower upper middle class
danagary: upper lower lower lower lower middle upper middle middle lower lower lower class
hansjohn: lower upper middle middle middle middle lower upper upper lower upper upper lower upper upper upper class
jackfrank: middle middle lower lower middle upper lower middle middle middle lower class
williamstanley: lower upper upper lower middle middle middle upper lower middle lower middle lower upper upper middle class
tommona: lower upper upper upper upper lower middle lower upper lower middle middle upper middle lower middle upper class
edbill: middle lower lower middle middle upper upper lower middle upper upper lower upper lower upper upper middle lower upper upper upper lower middle upper lower upper lower class
patriciamarian: lower middle middle lower middle class
rickcarla: lower upper middle class
beaanne: middle middle middle lower upper class
rickxavier: middle middle middle lower middle upper lower lower middle lower class
karldeanna: lower upper upper lower upper middle class
johnjack: lower middle middle upper lower lower middle upper upper upper middle upper lower upper class
carladana: upper middle upper upper class
williamhans: middle middle lower lower middle lower upper lower middle lower class
garypeter: lower lower middle middle lower middle middle upper middle upper middle upper lower lower lower upper upper lower upper class
williammonica: middle middle lower lower middle middle middle upper middle upper middle lower lower lower upper class
stanleydeanna: upper middle middle middle lower upper upper upper middle middle middle lower lower upper lower lower lower upper middle lower lower upper lower lower class
bobluann: upper upper upper middle upper middle middle middle middle lower lower middle lower lower middle upper middle middle upper class
arnoldpatricia: upper lower upper middle lower upper upper middle lower lower middle lower lower middle upper lower lower upper lower lower lower lower upper class
richstan: middle lower middle upper class
charlesjeff: upper upper middle lower upper upper lower lower upper lower middle lower lower middle lower lower upper class
bobmonica: middle middle class
carlamonica: upper upper upper middle middle middle lower lower lower middle middle lower middle middle lower middle middle lower middle upper middle upper middle upper lower class
xavierdavid: middle lower upper middle lower lower upper middle middle upper lower lower lower lower middle lower lower upper lower upper class
bobdana: lower upper lower upper lower lower lower middle lower lower middle upper lower middle upper upper middle upper lower lower middle lower upper middle middle lower upper class
edsue: lower lower lower middle lower lower upper middle middle middle lower lower middle middle upper lower upper lower middle middle middle lower lower lower upper middle class
arnoldrich: middle middle middle lower lower class
beabob: middle middle lower lower lower middle middle middle upper upper upper lower upper upper lower middle lower class
jackrick: lower upper lower middle middle middle upper upper upper upper lower middle lower upper upper upper middle lower upper lower upper class
richfrank: lower middle upper lower middle lower lower upper middle lower upper middle middle upper middle lower middle middle middle upper upper class
tompeter: middle lower middle upper middle middle class
dickbea: upper lower lower class
xavierjeff: middle middle middle upper middle middle middle middle upper upper lower lower class
garystanley: upper upper middle upper lower middle lower class
pativiolet: upper lower middle lower upper lower upper upper upper lower upper upper middle upper lower lower middle upper class
richardrick: lower upper upper upper lower lower middle lower upper lower middle class
markpeter: lower class
monicarick: upper lower middle lower upper upper lower middle lower lower middle upper lower upper lower class
patriciadana: middle lower class
violetdavid: upper upper middle middle upper upper upper upper upper middle middle middle upper middle middle lower middle upper lower middle middle middle lower lower lower upper class
danastan: middle class
billtom: upper upper middle upper lower middle upper middle upper upper middle lower upper lower lower lower class
harrymonica: upper middle lower middle middle middle lower lower middle middle upper middle upper upper lower middle lower middle lower lower middle upper upper upper lower lower class
carlbill: lower middle upper upper upper lower lower middle upper middle upper lower middle lower middle upper lower lower lower upper upper class
stanleymona: middle upper upper lower middle upper middle upper middle middle lower middle lower upper upper upper upper lower upper lower lower upper upper upper lower middle class
bobpati: lower lower upper lower middle lower upper upper middle lower lower upper lower upper lower lower lower middle lower lower upper lower class
patiwendy: middle upper middle upper middle lower upper middle class
violeted: lower middle middle upper upper upper lower lower upper middle lower middle lower lower lower class
stanleyxavier: upper middle upper upper upper middle middle upper upper lower middle upper class
arnoldarnold: middle lower upper middle lower upper lower upper class
josedick: lower middle class
carlmonica: middle upper lower middle upper upper upper upper upper lower middle lower middle upper lower middle middle lower middle upper class
mariandeanna: upper lower middle lower middle lower lower middle middle upper middle upper upper lower class
tomfrank: upper upper lower middle middle lower upper upper lower class
karlmark: middle middle upper class
peterharry: upper lower class
beaharry: upper middle lower upper lower upper lower lower upper upper lower class
arnoldanne: upper lower middle middle upper middle class
billdana: lower upper upper upper lower class
edharry: lower class
richardrich: middle middle upper lower lower lower middle middle middle upper upper upper middle middle middle lower upper upper upper lower upper lower class
suekarl: upper middle lower lower middle upper middle lower lower class
harrysue: lower lower lower upper upper upper class
carlakarl: upper lower lower middle upper middle lower lower middle upper upper upper upper middle middle middle middle lower upper upper middle middle lower middle middle class
annewendy: middle lower upper middle middle upper lower lower upper lower upper upper middle lower middle upper middle middle middle lower upper class
franzgary: lower upper upper upper lower lower upper lower upper lower upper middle upper lower upper lower lower upper lower upper upper middle upper lower lower lower middle class
annestan: middle lower upper middle upper upper middle middle upper lower upper lower upper upper lower lower middle upper upper lower middle lower upper lower lower lower class
danastanley: middle lower lower lower middle lower middle upper middle upper upper upper lower class
monicacarla: lower class
suemarian: middle upper upper lower lower upper upper middle middle upper upper upper middle lower lower middle upper upper upper lower middle class
patimonica: middle middle upper lower upper middle upper upper middle middle upper upper lower upper middle upper middle lower class
tommymary: middle middle middle upper middle upper upper middle middle lower upper upper lower middle middle middle lower lower lower lower lower lower middle lower middle lower class
tomwendy: lower upper lower middle upper upper upper middle middle upper middle upper lower upper middle upper lower lower middle middle middle upper lower middle middle class
johnfranz: middle class
charlesjose: upper middle upper upper middle class
xavierxavier: upper upper middle middle lower upper middle middle middle lower class
stanleyhans: lower lower upper upper middle upper lower lower middle upper middle middle middle class
rickjack: middle middle upper upper lower upper middle upper middle upper lower middle lower middle lower middle upper upper middle middle upper class
monamary: lower middle upper lower middle upper lower middle lower middle upper upper upper upper class
xavierwendy: middle lower middle middle upper upper lower class
peterkarl: lower upper lower upper middle upper upper middle middle lower upper lower lower upper lower lower lower upper middle upper lower upper middle middle lower middle upper class
garybea: upper lower lower lower lower middle upper middle lower class
deannajeff: lower upper class
carlfrank: lower lower upper middle middle lower upper lower middle lower lower upper lower lower middle lower upper lower class
patidavid: upper upper lower middle lower upper lower lower upper class
markwilliam: middle middle class
bobviolet: lower upper lower upper upper upper middle middle upper middle upper middle lower lower lower upper class
richarddeanna: lower lower lower lower middle lower upper upper lower upper middle class
johndick: upper upper middle middle lower middle upper middle upper lower lower lower upper middle lower upper upper lower middle upper middle middle upper middle class
frankhans: upper upper upper lower upper upper lower upper lower middle lower lower middle middle lower lower middle upper lower upper class
richtommy: upper middle middle middle lower lower upper lower upper middle middle upper class
xavierbea: upper middle class
violetfranz: upper upper middle middle middle lower class
stanbob: middle upper lower middle lower lower lower middle upper middle lower upper lower lower middle upper upper lower upper upper lower middle upper class
charlesstan: lower lower upper upper lower middle upper middle upper middle upper middle upper lower lower middle class
richardmona: middle lower upper lower middle middle lower middle middle upper lower middle middle lower lower lower lower middle lower lower middle upper middle class
rickstan: middle upper lower middle upper middle upper lower middle lower lower upper middle lower lower class
deannacarla: middle upper middle lower lower class
peteranne: upper lower class
edmona: lower middle middle lower middle class
richanne: lower lower middle middle middle lower lower lower upper lower upper class
arnoldtom: middle lower lower middle middle upper upper upper middle lower middle middle upper class
tomluann: upper middle upper upper lower lower middle class
tommyharry: middle upper lower upper lower middle middle lower middle lower lower upper lower upper upper class
arnoldstan: lower middle lower upper middle upper middle lower middle lower middle lower upper class
monaanne: upper middle lower upper lower lower lower upper upper lower middle upper lower upper upper lower middle middle upper class
luannjose: middle upper upper lower lower upper middle middle upper lower class
richardviolet: lower lower lower middle middle upper upper middle class
arnoldrick: middle upper lower upper middle middle upper lower class
harryarnold: upper middle middle upper middle middle lower lower upper lower lower middle lower upper upper middle lower class
stanleyanne: lower middle class
marysue: upper upper lower middle middle middle upper middle upper upper upper upper upper upper upper upper upper middle upper middle class
frankmary: lower lower lower upper upper upper middle upper lower lower middle upper class
monicaxavier: lower upper lower lower upper lower middle upper middle lower lower middle lower lower middle middle lower middle upper class
xaviertommy: lower middle middle upper upper lower upper middle upper lower middle upper middle class
johndana: upper upper middle upper middle middle lower class
josejose: lower lower middle lower middle lower upper lower upper class
karlcharles: middle lower upper lower upper upper middle upper middle lower class
tommyjeff: lower lower lower upper middle middle lower upper middle middle middle upper middle lower upper upper middle middle upper upper class
garyviolet: upper middle lower middle upper lower upper upper upper middle upper upper lower upper lower upper lower lower upper upper lower class
xavierrick: lower upper upper middle upper lower middle upper upper upper upper lower lower middle upper lower middle upper lower middle lower middle lower middle class
charlesrichard: lower upper lower lower lower middle upper upper middle middle lower upper upper lower middle lower middle middle class
williamdana: upper lower lower class
jeffmonica: lower middle upper middle upper upper lower lower upper upper middle upper upper middle lower middle lower upper class
jeffbill: middle upper middle middle lower upper middle lower upper middle lower upper upper lower middle lower middle lower middle upper lower lower middle class
josehans: lower lower lower upper class
tommypeter: middle middle upper middle upper middle lower middle lower middle lower class
wendytommy: upper upper middle middle class
franzrick: upper middle lower class
maryharry: upper upper upper middle middle lower upper middle upper middle upper middle middle upper class
charlesrick: upper lower lower middle middle upper upper middle upper middle upper lower middle lower class
patipatricia: lower middle middle upper upper lower lower upper lower lower upper upper middle middle middle upper lower lower middle middle middle middle middle upper lower class
billcarla: lower middle middle lower middle upper lower upper upper middle middle middle upper upper lower upper upper upper lower lower middle middle lower upper upper middle lower class
stanharry: upper upper middle lower lower lower middle lower upper lower lower lower lower upper class
richviolet: middle middle upper middle upper lower upper upper middle middle middle lower middle lower upper lower upper middle lower upper lower upper class
stanleypati: upper lower upper middle upper class
williamrick: middle middle lower lower middle upper middle lower upper class
monarich: lower middle lower lower lower upper middle lower upper upper middle lower upper middle upper lower lower lower upper upper middle upper class
williamcarla: middle upper lower lower middle lower lower upper middle middle upper middle upper middle upper lower lower upper lower lower upper upper lower middle lower lower class
patriciadick: upper upper middle upper middle lower upper middle lower lower lower middle middle upper upper middle class
luannhans: middle upper lower class
annetom: lower upper middle lower upper lower lower middle lower class
danaharry: upper middle middle middle class
bobstanley: upper upper upper middle lower upper upper middle lower upper lower upper lower middle class
wendyrichard: lower upper upper middle middle lower upper upper middle lower middle upper lower middle upper middle upper class
marycarla: lower lower middle middle upper lower middle lower lower lower class
frankdeanna: middle lower lower middle middle lower middle lower middle middle lower upper lower upper lower class
suesue: middle middle upper upper upper middle lower upper middle upper middle lower lower lower middle lower lower lower middle upper middle class
markcarl: lower upper lower middle middle lower lower lower middle lower lower class
wendydana: upper lower middle middle upper upper lower middle upper upper lower lower middle middle upper upper lower upper upper upper upper middle upper middle class
luannluann: upper upper lower middle upper middle upper lower upper lower lower lower lower upper lower lower lower upper lower lower upper lower upper upper lower middle lower class
xavierpati: lower lower middle middle middle upper upper middle lower upper upper lower upper lower lower middle upper lower lower class
danadeanna: middle upper lower middle lower middle lower middle lower lower middle lower middle lower lower middle class
carladavid: middle upper lower middle upper upper middle upper upper lower lower upper lower lower upper upper class
wendywendy: middle lower middle lower lower lower upper lower middle middle upper class
tomrick: upper lower upper middle lower middle middle upper middle middle upper lower lower class
monawilliam: middle lower class
bobjeff: upper middle upper upper middle middle upper lower lower middle upper upper lower lower lower middle middle middle middle upper upper upper middle middle lower class
garyed: middle upper middle lower lower lower middle upper upper lower lower upper middle lower upper middle upper upper upper class
rickmonica: upper upper upper upper lower lower lower upper middle upper lower upper lower middle middle middle middle upper lower lower upper middle middle class
jeffstanley: lower lower upper upper lower upper lower lower class
billkarl: lower middle middle middle upper middle upper upper class
davidrichard: middle upper middle lower middle upper class
tommyrichard: upper middle lower middle lower middle lower upper lower lower middle lower lower lower upper upper upper upper middle upper class
richfranz: middle middle upper lower lower middle middle upper lower upper upper class
tomrich: lower upper class
edmary: lower middle lower lower middle middle upper lower upper middle lower upper middle middle middle lower class
monaharry: upper upper middle lower upper class
monaviolet: middle middle middle lower upper class
johnhans: upper lower middle lower upper upper lower middle lower upper middle upper lower upper middle middle middle upper upper middle lower upper middle upper middle class
annemonica: middle middle upper middle upper middle upper middle lower lower upper lower middle middle middle lower middle lower middle middle upper class
beaviolet: upper upper middle upper middle upper lower lower upper upper middle middle class
richardbill: upper upper lower lower middle upper upper upper middle upper lower lower upper lower middle lower class
edarnold: upper middle upper lower class
dickstanley: middle middle upper class
franksue: upper upper lower middle upper upper upper upper upper middle class
billdick: upper middle lower lower upper lower lower upper lower middle middle upper middle lower upper class
karlcarl: lower upper upper upper lower lower middle middle middle lower upper upper lower lower lower class
peterdavid: upper upper middle lower upper upper upper lower lower lower upper upper class
franzmona: middle upper lower lower lower lower middle lower middle lower lower lower upper lower lower lower lower lower class
richardfrank: lower lower lower upper upper upper middle lower upper upper upper lower class
billanne: middle upper upper lower lower middle class
garypati: lower upper middle upper middle upper middle upper upper lower lower lower middle lower upper lower middle middle middle class
deannajose: lower middle upper middle middle upper upper upper middle lower class
karlfranz: lower lower middle lower middle upper upper middle middle upper middle middle lower lower lower class
suedick: upper lower upper lower lower middle middle upper upper lower upper upper lower middle middle lower lower middle middle middle middle upper middle upper middle lower class
violetrichard: upper middle upper upper lower upper class
dickmary: lower class
rickharry: lower middle lower middle upper middle middle upper lower lower middle upper upper middle lower middle upper lower lower lower upper middle middle upper upper lower upper class
harryrichard: middle middle upper upper middle middle lower middle upper lower upper lower upper lower middle upper middle upper lower class
monacharles: lower lower upper upper middle lower middle middle lower lower middle lower upper upper lower lower lower middle class
arnoldcarl: middle middle middle middle lower lower middle middle lower lower lower middle middle upper upper lower middle upper lower lower class
richbea: middle class
danacharles: upper upper middle lower upper lower upper upper middle lower lower middle upper upper upper class
garyfrank: middle lower lower class
deannapati: middle lower middle upper middle middle lower middle upper upper upper upper upper lower lower upper lower middle class
jefffranz: upper upper middle lower middle upper upper middle middle lower lower middle upper upper middle upper middle lower middle middle lower upper upper lower middle class
stanwendy: upper middle upper upper middle middle middle upper middle upper middle lower upper class
hansarnold: middle lower upper middle lower class
davidviolet: upper middle middle middle lower upper upper middle upper lower upper middle upper middle middle lower lower lower lower upper upper lower middle middle middle lower class
marypati: lower lower upper upper lower upper lower middle upper middle lower lower middle upper lower lower class
carlxavier: middle upper middle lower upper lower middle lower middle upper lower lower middle lower class
wendycarl: upper middle upper upper upper middle upper upper upper middle lower middle class
carlacarla: lower upper lower upper middle upper lower middle middle upper middle lower class
charlesstanley: upper middle upper middle middle middle class
josewendy: upper upper middle class
violetfrank: upper lower upper upper lower middle middle upper upper upper lower middle lower lower lower lower lower lower upper lower middle upper lower class
patriciacharles: lower middle lower lower lower middle lower upper lower lower lower lower upper lower middle class
tommybob: upper class
charlesanne: upper upper lower middle upper upper lower lower middle upper middle lower middle upper lower upper middle middle upper lower class
frankdana: upper lower middle middle upper middle lower middle lower lower class
hanstom: lower middle middle lower upper upper upper lower lower middle upper lower lower upper lower middle lower lower lower lower lower middle upper upper upper class
maryjack: upper lower class
beajose: lower upper lower upper upper lower middle middle lower upper middle middle upper middle lower upper class
patriciaharry: upper upper middle upper lower upper middle middle lower middle lower middle middle middle upper lower class
billstan: upper upper lower lower middle class
johnanne: lower middle upper lower upper lower lower middle lower lower middle middle middle lower middle upper upper upper lower lower middle lower class
maryjeff: middle middle lower class
charleswilliam: middle upper upper lower upper upper lower upper upper middle middle middle upper class
carlarnold: middle middle upper upper upper middle lower middle middle upper class
frankdick: middle lower lower upper middle lower middle upper lower middle class
danapati: middle upper lower lower lower middle middle upper lower middle lower middle class
harrystanley: middle upper upper lower lower upper middle upper lower upper middle middle class
arnoldmary: upper middle lower upper middle middle upper middle upper middle middle upper upper upper middle upper lower middle upper middle upper class
annerich: upper upper middle upper lower middle lower middle lower upper lower lower upper middle lower middle middle upper middle middle class
monabob: upper upper lower lower class
wendycarla: upper upper middle middle lower middle lower middle middle lower lower upper lower class
violetmona: middle lower class
davidtom: upper upper lower lower middle lower upper lower upper upper middle middle upper upper middle lower lower upper upper class
franked: middle middle upper middle lower upper class
petertom: middle upper middle lower upper middle lower upper middle lower upper upper upper lower middle lower lower lower upper class
violetgary: middle middle lower lower middle upper lower upper lower upper lower lower middle upper middle middle upper lower middle upper upper lower upper middle upper middle middle class
richluann: upper middle lower middle middle upper middle lower upper upper upper lower lower middle lower upper upper middle lower middle lower middle class
monicacarl: lower class
monicatom: lower lower middle lower middle lower upper class
billbea: upper lower middle class
garyanne: lower upper middle lower upper middle lower upper middle upper upper lower upper lower lower middle lower lower lower middle lower lower middle middle middle class
rickcharles: upper class
anneed: lower upper lower middle lower upper middle upper upper lower upper middle lower upper middle lower middle lower middle class
xaviered: lower middle lower middle middle middle class
franzfrank: middle upper upper lower middle middle upper middle lower upper middle lower middle lower upper upper lower middle lower upper middle lower upper lower middle class
tommymarian: middle lower lower lower upper lower lower lower middle middle lower lower upper middle upper upper middle class
johngary: upper middle upper middle upper middle upper middle upper upper upper lower lower middle middle lower upper lower middle upper upper middle class
arnoldjohn: upper lower upper upper middle lower lower middle middle lower upper lower middle lower upper middle lower upper upper lower upper upper upper middle class
danafrank: upper lower lower lower middle upper upper upper lower lower middle upper upper upper class
marianviolet: middle upper upper middle lower lower upper upper middle upper class
luannsue: upper upper lower upper upper lower upper lower lower middle upper lower middle lower upper middle upper middle upper upper class
carlanne: upper upper lower upper middle middle upper middle lower lower lower middle lower middle lower upper lower lower class
franzfranz: middle upper class
carlagary: middle upper middle middle middle upper middle middle lower upper upper upper upper lower middle upper middle lower upper middle lower upper class
josejohn: upper lower upper upper upper middle middle middle lower lower middle upper middle lower middle upper upper lower lower middle lower middle upper class
deannapatricia: lower upper middle lower lower lower class
maryluann: upper middle upper middle lower class
jacktommy: lower lower middle upper upper lower middle middle middle upper lower middle upper lower upper middle lower upper lower lower middle upper lower middle middle middle middle class
suefrank: middle lower middle lower middle lower upper lower middle upper upper middle class
annemary: lower upper lower middle lower lower upper middle lower middle middle upper lower lower upper middle middle lower class
rickdavid: lower upper lower upper upper lower lower lower upper class
markluann: middle middle middle lower upper upper middle middle middle lower upper lower middle lower lower middle upper upper upper upper middle lower lower class
carlpatricia: lower upper upper lower class
maryrichard: upper upper middle class
luanncarl: middle lower lower upper lower upper lower upper middle lower lower middle middle lower middle middle upper lower middle middle upper upper middle upper class
sueharry: lower middle middle middle upper upper middle middle lower middle upper lower lower lower lower lower middle class
arnoldmona: upper upper upper lower lower upper middle lower middle lower upper lower middle upper upper upper lower lower upper middle class
richardcarla: middle upper upper upper class
dickarnold: upper middle upper middle upper lower upper upper lower middle lower middle class
charlescharles: lower lower middle middle upper upper upper middle upper middle middle class
violettommy: lower middle lower upper lower middle lower upper middle lower upper upper upper upper middle upper class
suearnold: middle lower lower lower middle middle middle upper upper middle upper upper upper middle lower middle upper upper lower middle middle middle middle middle lower middle class
harrymarian: middle middle lower middle middle middle upper middle lower middle lower middle upper upper lower class
deannaluann: upper middle upper middle lower lower upper upper lower upper lower middle upper middle class
tommyrick: upper upper upper middle lower lower lower upper lower lower upper lower upper lower lower middle lower middle middle upper middle lower upper upper lower middle class
monicawilliam: middle lower lower lower upper lower lower middle lower upper upper upper lower upper lower middle upper middle lower lower lower lower lower lower lower upper class
josexavier: middle middle class
eded: lower middle upper lower upper upper middle lower upper upper upper upper class
carlarichard: middle upper lower middle middle middle lower upper middle middle middle middle middle middle middle middle upper class
xaviercarla: upper middle middle upper upper lower lower middle middle middle middle middle lower middle upper upper upper class
jackpeter: lower upper lower lower middle lower lower upper lower middle lower middle middle upper upper lower upper upper lower lower middle middle upper class
annepeter: middle upper lower lower lower upper middle upper lower lower upper lower upper upper lower middle middle middle upper class
johnharry: upper lower upper middle upper lower middle lower middle middle middle upper upper class
karlrich: upper lower middle lower middle middle upper upper middle lower upper middle middle lower lower upper middle lower lower lower lower middle lower upper middle upper upper class
carlamona: middle middle upper upper upper lower middle lower middle upper upper middle upper lower middle lower lower upper middle lower class
annewilliam: lower upper upper lower lower upper lower lower lower lower middle class
franzjose: lower upper class
davidcarla: lower lower upper upper lower middle upper lower lower middle upper upper middle middle lower lower lower middle lower middle lower class
beastan: lower upper class
garymary: middle upper lower upper lower upper upper upper middle lower lower lower lower lower middle middle upper lower upper lower upper upper upper middle middle lower lower class
daviddavid: middle upper upper lower middle upper middle upper upper upper middle upper middle middle lower middle upper upper middle lower middle upper upper middle class
peterluann: middle middle middle middle upper lower lower lower class
luanned: lower lower lower class
franzbill: upper upper middle upper upper middle middle lower upper upper middle upper upper upper upper lower upper lower class
charlesxavier: middle lower upper upper class
garyjeff: lower upper lower upper lower lower lower middle lower middle middle lower upper upper lower lower upper upper class
markdeanna: upper upper lower middle middle upper lower upper class
patriciawendy: upper middle middle lower middle lower lower middle lower upper middle lower class
marianxavier: lower upper upper middle middle middle class
luannpeter: middle upper middle upper class
deannarich: upper upper upper class
deannaharry: middle lower middle upper lower lower upper middle lower middle lower middle middle lower lower middle upper class
stanleycarla: middle middle upper upper lower middle upper middle upper upper lower class
harrykarl: middle middle upper class
eddick: upper lower upper middle lower middle middle middle middle class
carladeanna: middle middle lower lower lower class
edmark: lower middle upper upper upper lower middle upper upper upper upper middle upper upper lower class
stanleymark: upper middle upper lower upper lower upper lower upper upper lower middle middle upper upper middle lower upper lower upper middle lower upper class
beabill: lower middle lower lower lower lower middle lower middle middle upper lower upper middle upper middle lower upper class
tomdavid: upper lower upper lower upper upper middle upper middle upper lower middle middle upper lower lower middle class
frankjeff: middle lower upper upper lower middle upper middle middle lower lower lower upper middle upper lower upper middle lower middle lower lower upper middle lower middle class
stanleybea: middle lower lower upper upper lower upper middle lower middle middle lower upper middle class
johnrichard: lower middle upper middle upper middle middle lower lower lower middle upper middle middle middle upper upper middle middle middle middle upper upper class
williampeter: middle middle middle middle lower upper lower lower class
garydavid: middle upper lower middle middle upper upper upper middle lower upper upper middle upper lower class
jeffarnold: upper lower middle upper lower middle middle lower upper middle lower upper class
petermona: upper middle middle upper upper upper upper upper middle upper middle lower middle lower middle middle lower lower lower upper upper lower middle lower class
marybob: upper lower upper upper middle middle upper middle class
stanleyrichard: lower lower middle lower lower lower upper middle middle lower lower lower upper lower lower middle upper lower upper lower middle lower middle upper middle middle lower class
williamrichard: middle middle upper upper lower middle upper upper class
johndavid: upper lower lower middle middle upper upper middle lower middle lower upper upper lower middle lower lower lower middle middle class
karlrick: upper upper lower middle lower upper class
tommybill: middle upper lower lower middle lower upper lower middle upper middle middle middle upper middle lower class
charlesfranz: middle middle class
marianbob: middle middle lower upper upper upper middle middle middle lower lower middle middle middle middle upper lower middle upper upper middle upper lower upper middle class
carlaanne: lower middle lower lower upper upper middle middle lower middle lower upper lower upper upper lower middle middle upper class
garyhans: upper upper lower class
harrydeanna: upper upper middle class
garyrick: upper lower lower upper middle lower upper lower middle upper middle middle middle middle middle lower middle lower middle class
carlrick: middle middle lower upper upper lower lower middle lower lower upper class
beaed: middle middle upper class
monicaed: upper upper upper middle upper middle middle lower lower upper upper upper upper middle middle middle middle upper upper middle middle lower lower lower upper class
xavierstan: lower middle upper middle upper upper upper class
tommary: middle middle lower upper middle lower lower upper lower lower upper upper middle middle middle upper middle upper lower lower middle upper upper class
xavierrichard: middle upper lower lower upper lower upper upper middle upper middle upper middle lower upper upper lower middle lower upper upper middle upper middle lower upper class
richbob: upper upper lower middle middle middle upper lower middle class
johnrick: lower lower middle lower upper middle middle lower lower lower middle lower middle lower middle upper class
monafranz: middle middle middle lower middle class
franzviolet: lower upper middle middle upper middle upper middle lower lower middle lower lower middle class
marydick: middle upper middle lower middle middle middle middle middle upper middle lower upper upper lower lower lower middle lower middle lower upper lower class
franzmonica: middle middle lower class
karlstan: middle middle lower upper upper upper middle lower upper lower lower middle middle upper class
frankkarl: middle upper upper middle lower middle upper class
peterxavier: middle middle upper middle middle upper lower lower upper middle middle lower upper middle middle upper middle lower lower lower middle upper class
williambea: lower middle lower lower upper lower upper upper lower upper upper lower lower upper upper upper middle class
karlsue: upper upper class
beagary: upper upper lower upper upper upper upper lower upper lower middle lower middle upper lower middle upper upper lower upper lower lower upper middle lower class
tomkarl: middle upper middle lower lower upper middle middle middle lower lower upper lower upper class
maryed: lower lower upper upper lower lower middle lower middle upper middle upper middle class
danawilliam: middle middle lower upper middle lower upper upper upper lower lower upper lower lower upper middle upper middle class
hansbob: upper lower upper lower upper middle lower upper lower upper lower lower lower lower lower lower upper middle middle lower lower upper middle upper lower class
patibob: upper lower middle upper lower lower lower upper upper upper lower upper class
hansmonica: lower middle lower upper middle lower upper lower middle lower middle class
danasue: middle upper lower lower upper lower lower lower middle upper lower lower upper class
luanntommy: middle middle upper middle lower upper lower upper upper class
charlesarnold: lower middle lower upper middle middle upper class
wendyarnold: middle middle upper upper middle lower middle middle middle lower middle middle middle upper middle class
frankviolet: lower middle upper lower lower middle lower lower lower upper middle upper lower middle upper lower class
beamarian: middle upper upper upper upper middle lower upper upper lower middle lower middle middle upper middle lower lower lower lower middle middle upper middle upper lower class
markmark: middle middle lower middle upper middle upper lower middle upper upper lower upper upper upper middle middle middle middle middle upper upper upper middle lower upper class
frankjack: upper upper middle upper upper lower lower upper middle lower middle lower lower lower upper upper middle lower lower upper middle middle middle lower middle class
markrichard: middle upper lower lower middle class
edtommy: upper lower middle upper middle upper lower middle lower lower lower middle lower lower middle class
stanpeter: upper lower middle lower class
violetcarl: middle lower upper upper upper middle lower lower class
markxavier: middle upper lower upper lower lower middle middle lower lower middle lower upper lower lower upper lower lower class
richtom: lower upper upper middle upper class
charleshans: middle middle middle upper lower upper middle lower upper lower middle lower middle lower lower middle lower middle lower upper lower upper class
carlastan: upper upper upper middle middle class
arnoldwendy: middle middle middle lower upper middle lower middle middle middle upper lower class
monicatommy: upper middle middle middle lower lower lower middle middle upper lower middle upper lower middle upper lower lower upper lower middle upper upper class
johncharles: upper class
markmona: upper upper upper middle lower upper upper upper upper middle lower lower class
petercarl: lower upper middle lower middle upper middle middle middle upper middle middle middle middle lower lower class
patimarian: upper middle upper middle class
tomtom: lower upper lower middle lower lower middle middle middle lower upper lower lower upper lower upper lower lower middle lower lower upper upper class
edrich: lower middle lower lower middle middle lower lower upper upper class
richdick: upper lower lower upper upper upper middle class
xavierjack: middle middle lower upper upper middle lower middle lower lower upper lower middle lower middle lower lower lower lower lower middle lower class
franzcharles: lower upper upper upper upper middle upper lower lower upper lower upper upper upper middle middle middle upper middle lower lower lower lower upper class
carlamarian: middle middle upper middle lower lower class
dickcarl: lower upper middle upper middle middle lower middle middle middle lower middle middle upper middle upper upper class
dickpatricia: upper upper middle class
stanleytommy: lower upper lower upper middle middle upper middle middle lower middle lower lower upper middle middle upper lower upper middle class
williamdeanna: middle middle class
carldana: upper middle upper upper lower class
jeffpati: middle upper class
xaviermark: lower upper lower upper upper middle upper lower upper middle lower class
marianmonica: middle middle middle middle middle lower lower middle upper middle lower middle middle class
stanrick: lower lower upper upper upper upper upper upper middle lower middle lower middle lower middle lower upper upper lower upper class
annecharles: upper lower middle middle upper upper upper upper upper middle middle middle upper upper lower upper lower class
wendypatricia: upper middle upper lower middle class
johnpati: upper class
wendystan: upper upper lower upper upper upper lower upper middle lower lower upper lower lower upper middle upper upper lower middle upper lower lower middle upper lower upper class
karled: upper upper upper lower middle upper upper upper lower middle upper upper lower middle upper middle upper upper upper class
josebill: middle upper middle middle upper lower upper upper middle upper lower lower lower middle lower lower lower upper middle middle middle middle class
jeffdeanna: middle middle lower middle lower lower lower middle lower middle lower lower middle middle middle upper middle upper class
patriciamona: lower middle middle lower lower lower lower upper middle class
charlesharry: upper middle lower upper upper lower class
dickpeter: upper middle middle upper upper lower class
josemark: lower lower lower lower lower lower lower upper lower upper upper lower lower lower lower upper lower lower middle middle lower middle upper upper upper upper class
annearnold: upper upper lower upper upper middle middle middle lower upper lower upper lower middle upper middle upper lower upper upper lower upper upper upper class
charlesviolet: lower lower class
stanjack: upper class
charlespatricia: lower lower class
edbob: upper upper lower upper lower lower middle lower lower upper lower upper class
bobcarla: middle middle lower middle upper upper lower lower lower middle class
joserichard: upper middle middle lower upper upper lower middle middle middle middle upper upper middle middle upper middle upper upper class
charlesjack: lower middle lower middle middle middle lower lower upper middle upper lower upper lower upper upper middle lower lower lower class
markviolet: lower class
sueluann: lower upper middle middle lower middle lower middle middle lower upper middle lower lower middle upper middle middle upper lower middle upper class
jeffmark: upper lower middle lower lower lower lower lower middle upper upper upper middle upper middle upper middle middle upper lower middle lower middle middle middle upper middle class
dickcarla: upper middle lower lower lower middle class
richardarnold: upper lower middle middle lower upper middle middle lower middle class
violetstan: upper middle class
bobwendy: middle middle lower middle upper lower middle lower lower lower middle middle lower lower middle middle lower upper middle lower class
luannarnold: lower upper upper upper middle upper lower class
hansdick: lower lower lower middle middle middle lower lower middle upper upper middle lower middle middle upper lower lower lower upper class
billcarl: upper lower upper middle lower lower middle lower class
danaanne: lower upper upper upper class
davidhans: upper upper upper middle lower upper lower lower upper middle middle lower middle lower middle middle middle lower middle upper upper upper middle middle class
hansbea: upper middle class
garyxavier: middle lower middle upper lower upper middle middle upper upper upper middle middle upper middle upper upper lower upper lower middle upper upper middle upper upper class
petercharles: middle middle lower lower lower upper upper middle middle middle class
annedana: lower middle upper lower upper upper upper middle middle middle upper lower upper middle middle middle middle upper lower middle lower middle lower middle lower class
harryviolet: middle upper lower lower lower middle upper middle middle upper middle middle middle middle class
suefranz: lower upper lower middle lower middle lower middle upper middle lower lower lower middle upper upper middle upper lower upper upper middle upper lower lower middle class
patiarnold: lower lower upper lower upper middle upper class
arnoldwilliam: upper upper lower class
markrich: upper upper lower upper middle upper lower upper upper upper middle middle middle middle lower lower upper middle lower middle middle middle upper upper lower middle class
stanleyarnold: upper middle middle middle lower lower upper upper middle middle upper middle middle upper middle middle middle lower lower middle middle lower class
patijeff: middle upper upper middle upper middle middle middle middle middle middle class
carlpati: upper lower lower lower lower lower lower upper upper upper middle upper lower lower middle upper upper middle middle lower upper upper middle middle class
bobmona: middle lower upper upper upper upper middle lower upper middle lower lower upper upper middle lower lower class
carladick: middle lower lower lower upper upper middle middle lower lower middle lower lower middle lower upper lower class
carljose: upper upper lower middle middle lower lower lower lower lower middle lower class
karlarnold: lower lower middle upper upper class
wendyjeff: middle lower middle middle lower upper class
tomxavier: middle lower lower lower middle lower lower middle upper lower lower upper upper lower middle upper upper upper lower middle lower upper middle lower class
deannadana: lower middle middle middle lower middle lower lower upper lower middle middle lower lower upper middle upper lower class
luannbea: middle lower middle upper upper lower middle upper middle lower middle middle upper lower class
patidick: lower upper upper lower middle upper upper lower middle lower lower class
peterjack: upper lower lower lower lower middle lower upper lower lower lower upper lower lower upper middle middle class
johnfrank: lower middle lower lower middle upper lower upper upper middle upper middle lower lower class
carlrichard: lower lower upper lower upper upper upper middle middle middle upper middle class
violethans: middle upper upper lower lower middle middle lower lower lower middle upper class
patihans: upper upper middle middle lower lower upper lower lower middle middle lower lower middle upper upper middle lower lower middle lower lower lower middle upper class
jackcarla: upper upper lower lower upper lower upper middle upper lower upper lower lower middle lower class
xavierjose: lower middle middle upper upper lower upper lower lower lower lower middle lower upper lower lower upper upper upper upper middle middle lower middle upper lower class
dickrichard: lower upper upper upper middle upper middle upper lower middle middle middle middle upper lower upper upper lower lower upper upper lower middle lower class
davidbill: upper middle lower middle upper middle middle middle middle middle upper middle middle lower upper upper lower middle upper upper lower middle lower upper middle lower class
xavierjohn: lower lower upper middle class
annebill: lower upper upper lower lower middle lower lower middle upper lower middle lower upper middle lower middle upper class
wendyxavier: upper middle upper middle upper middle upper lower middle lower lower upper lower middle lower lower middle lower upper middle lower class
billrick: middle lower middle upper upper lower lower middle upper middle lower lower lower lower lower upper middle lower upper upper upper lower class
stanwilliam: upper class
violetharry: lower lower upper lower lower lower lower lower upper upper middle lower middle lower lower lower middle middle class
richpati: middle lower upper lower lower lower middle class
suecharles: lower middle upper upper lower upper middle middle upper upper middle middle upper lower class
luanncharles: upper lower lower lower upper middle upper middle upper upper lower middle lower upper lower class
rickmark: upper upper upper upper upper upper upper middle lower lower upper upper middle class
bobtom: lower class
williamjeff: upper upper middle middle middle class
arnoldfrank: lower class
franzhans: upper middle lower lower upper upper upper lower upper lower upper lower upper middle upper lower middle upper upper upper lower middle middle class
dickstan: upper lower lower lower lower middle upper lower lower middle middle middle lower upper middle upper middle upper upper upper middle class
carlahans: upper lower lower middle middle middle middle lower upper middle lower middle upper lower middle lower lower upper lower middle upper middle upper class
josecarl: middle lower lower lower middle upper lower upper lower class
maryrich: lower lower class
daviddick: upper upper upper upper upper lower lower upper lower lower upper class
monajeff: middle middle upper lower middle class
josebob: upper upper lower lower lower middle upper class
edcharles: upper middle middle middle lower upper lower lower lower lower lower middle class
violetdeanna: upper lower upper upper upper middle class
danajeff: middle middle upper lower upper lower middle lower lower upper middle upper middle middle upper upper class
danadick: upper lower lower middle lower middle middle upper upper upper lower lower middle lower upper middle lower middle upper lower lower upper lower upper upper upper class
arnolddavid: middle upper lower upper lower upper class
stangary: middle middle lower middle middle upper lower upper lower lower lower upper middle upper lower lower lower middle middle lower lower lower lower middle middle middle class
carlajohn: middle upper upper upper lower upper lower middle lower lower middle lower upper lower lower lower upper middle upper lower lower middle middle lower class
dickdana: lower class
franzed: upper middle upper middle upper upper middle middle middle middle lower upper upper upper upper middle lower lower lower class
karlharry: middle middle upper middle upper middle middle lower lower upper lower middle lower lower upper upper lower middle middle upper lower middle middle middle upper lower class
mariankarl: lower upper lower middle middle lower class
carltom: lower upper lower lower middle upper lower middle class
billwilliam: middle upper class
beamona: upper upper upper upper upper upper upper lower lower middle lower upper lower lower class
richmarian: middle class
suewilliam: middle lower middle lower upper class
jacktom: lower class
beadana: middle middle lower upper lower middle upper lower class
billarnold: middle upper lower lower upper lower upper middle upper upper upper lower middle middle middle lower middle class
carlbob: lower upper middle lower middle middle middle upper middle class
johnbill: lower middle upper lower lower lower middle upper upper class
peterarnold: upper upper middle middle lower upper upper upper lower middle upper upper lower upper middle middle lower upper middle lower middle lower class
wendybob: middle middle lower lower upper middle upper lower lower upper upper class
johnsue: middle lower lower middle middle lower upper upper upper middle lower middle lower middle lower upper upper lower upper middle upper lower upper class
stananne: middle lower upper upper middle lower upper lower upper middle lower lower lower upper lower lower upper lower lower upper upper middle upper middle lower lower class
patifrank: upper lower middle upper upper upper middle lower upper upper lower upper upper middle lower class
karljeff: lower lower lower upper middle middle middle upper middle middle middle upper class
monacarla: upper upper middle upper upper middle middle lower class
luannmonica: upper middle upper upper lower upper upper middle lower upper middle middle class
markbea: middle upper upper middle middle upper lower class
garypatricia: lower lower lower class
violetmark: middle upper middle lower lower lower upper middle upper lower upper upper middle upper middle upper upper class
patikarl: upper middle lower middle middle lower lower upper lower lower middle lower lower lower middle upper middle lower lower class
dickrich: upper lower middle lower upper lower middle lower upper middle middle lower lower middle class
frankpati: upper lower lower middle upper lower middle middle upper lower middle lower lower middle upper upper upper middle lower lower lower lower upper upper class
marianarnold: lower lower lower middle lower lower middle class
williamdavid: lower middle lower lower lower lower upper lower middle lower upper lower middle middle lower class
franzpati: upper upper upper lower lower upper lower class
patriciabob: lower middle middle class
monabill: middle upper middle upper upper upper class
richarddana: upper upper lower upper lower lower middle lower lower middle middle middle upper upper lower lower class
davidbea: upper lower middle lower upper lower middle middle lower lower middle upper upper middle middle lower lower class
carlajeff: upper lower upper upper middle middle lower upper upper middle upper lower upper middle upper middle upper class
wendyviolet: upper middle upper middle lower middle upper middle lower middle upper middle lower upper upper middle upper middle lower lower class
beasue: lower middle lower upper middle lower upper lower middle lower lower middle lower lower upper lower class
monicajohn: upper upper lower middle upper upper middle middle upper class
tommypatricia: lower middle lower upper lower lower lower middle middle middle upper upper lower lower upper middle lower lower lower lower lower lower middle middle upper upper class
arnoldxavier: upper upper lower middle upper middle lower middle middle upper upper upper upper upper lower upper lower lower middle middle upper upper middle lower upper upper class
ricktom: upper lower lower middle middle lower lower lower upper lower upper lower middle middle upper upper class
carlacharles: upper lower middle lower middle lower upper class
xavierdana: middle upper lower middle upper lower lower middle lower middle upper lower middle lower upper class
patipati: lower lower lower middle lower lower lower lower middle lower middle upper upper lower middle lower lower middle upper upper upper upper lower upper lower upper class
tomarnold: middle middle middle upper lower middle lower middle middle upper upper upper middle middle upper upper lower upper lower class
jackdavid: upper lower middle upper middle upper middle upper upper middle upper class
stanleyjeff: middle upper upper upper middle upper lower upper upper upper middle class
marianpeter: middle middle upper lower middle upper middle lower middle upper lower lower upper lower upper lower middle middle upper middle lower upper lower lower middle lower upper class
johnmona: middle middle upper upper lower upper middle upper upper upper upper middle middle upper upper upper middle lower middle middle upper upper middle middle class
patriciajack: upper middle lower upper lower lower middle lower middle upper lower middle middle middle middle upper lower upper class
annebea: upper class
frankluann: lower lower middle middle middle lower middle middle middle upper middle middle lower middle upper class
tombob: upper upper upper middle upper upper class
williamsue: lower middle lower upper class
danajose: middle middle upper lower lower upper upper upper upper lower middle lower middle lower lower upper middle middle class
mariancharles: middle lower upper lower upper middle middle middle middle lower lower upper upper class
karlbill: upper lower upper middle middle lower middle middle lower lower middle upper middle middle class
jackstan: lower class
franzrich: upper upper upper lower lower middle lower upper middle middle lower middle middle lower lower middle lower lower class
richardxavier: middle upper middle upper middle middle lower upper lower lower lower middle middle middle middle middle lower upper upper middle middle lower upper upper upper upper class
stansue: lower upper upper upper middle upper upper lower middle lower middle class
monaed: lower lower lower middle lower class
hansdavid: middle lower upper upper upper upper upper lower lower upper middle lower middle lower lower upper middle upper upper lower middle class
peterwilliam: lower middle lower middle lower upper middle middle upper lower lower upper upper middle lower middle upper lower lower middle lower lower upper upper upper lower class
monicamona: middle middle upper middle upper lower middle class
patijose: upper upper class
danapatricia: middle upper upper upper middle middle middle upper lower lower middle class
harryed: upper lower middle lower lower middle upper lower middle upper upper middle upper upper lower upper lower middle middle middle lower upper lower lower middle class
paticharles: middle middle middle middle upper lower middle middle middle middle lower upper upper upper middle class
johnpatricia: middle lower upper upper lower lower lower middle middle middle lower lower lower lower lower middle middle middle middle upper upper lower middle class
rickjeff: lower class
markdavid: middle middle lower upper lower middle lower middle middle middle class
carlaharry: middle upper upper lower lower upper lower upper lower middle lower lower upper middle middle lower upper lower lower class
peterstanley: middle lower upper middle middle middle upper lower middle upper class
jeffbob: upper lower upper lower middle middle lower upper middle middle middle class
harrytom: upper middle middle middle upper lower upper lower upper lower middle lower middle lower middle lower middle upper upper lower class
garywilliam: middle lower upper lower middle upper middle middle class
karlgary: lower class
marianpatricia: upper middle middle middle lower middle lower upper lower lower upper middle lower lower lower upper middle middle lower upper class
peterstan: lower upper middle upper upper lower upper lower upper middle class
richdavid: lower middle upper class
patriciafranz: upper middle middle middle lower upper middle middle lower upper lower lower middle middle middle upper lower lower class
danaluann: lower lower middle middle upper middle upper upper middle lower middle lower middle upper middle upper middle upper upper upper lower middle middle upper middle class
williamjohn: lower middle middle middle lower lower lower upper lower middle lower lower middle middle middle upper middle middle upper lower class
marianwendy: upper lower middle middle middle lower upper middle lower upper class
frankharry: lower middle class
hansjeff: middle class
suewendy: upper upper upper lower middle class
markcharles: upper middle upper middle upper middle middle class
stanleyrich: lower upper upper upper middle middle class
markharry: lower lower upper lower upper lower lower lower middle upper upper middle middle class
garyfranz: lower middle upper class
tommytom: middle upper middle middle lower middle lower upper middle lower lower middle lower lower upper upper middle middle upper class
patriciabea: upper upper lower middle lower lower upper middle lower upper class
stancarl: middle upper middle upper lower upper middle upper upper upper upper lower lower lower lower middle lower lower lower upper lower lower lower upper lower upper upper class
karlluann: middle middle lower lower middle upper middle lower upper middle middle upper upper lower upper upper middle lower lower lower upper upper middle lower middle upper middle class
luannrick: lower upper class
williambill: upper middle middle upper middle middle middle upper middle middle lower upper middle lower lower upper class
johncarl: upper upper upper upper lower middle middle upper middle lower lower upper lower middle lower upper middle upper middle upper upper middle lower class
deannatom: upper upper middle upper upper middle middle upper lower lower class
luannpatricia: middle middle middle lower upper upper lower lower middle middle lower lower upper upper lower upper class
josearnold: lower lower lower middle lower upper upper lower upper lower upper upper class
hansstan: upper lower middle lower middle middle middle middle class
luannviolet: middle middle upper middle middle middle middle upper upper upper upper class
monicamarian: upper lower middle upper lower class
beawendy: lower middle upper middle upper lower upper middle upper middle upper lower middle upper lower upper upper lower middle upper upper middle class
charlesrich: upper lower middle upper middle middle middle upper lower middle middle lower middle lower upper class
patiharry: lower lower lower middle lower upper class
josemary: lower middle class
maryjohn: middle upper lower upper middle upper upper lower upper lower lower middle upper middle middle middle middle middle upper upper lower upper middle middle middle lower class
karldavid: middle middle middle lower upper lower upper upper upper middle upper upper class
monicajack: upper upper lower middle lower lower middle lower class
frankstan: upper lower middle lower middle upper lower upper upper upper lower lower class
patriciajeff: lower upper lower lower upper lower middle upper class
deannadick: middle lower upper middle upper middle lower middle middle lower middle upper lower lower class
garymonica: middle upper upper upper lower upper lower middle upper lower middle upper upper upper lower middle lower middle upper upper upper class
richmary: upper lower upper class
markjeff: upper class
xavierpeter: upper middle middle upper upper upper middle middle lower middle lower upper middle lower lower upper middle upper middle upper lower upper upper lower class
williamkarl: middle middle middle upper lower upper middle middle lower upper upper middle class
frankfranz: middle class
franktommy: middle upper lower lower lower upper middle lower middle class
monasue: lower lower lower middle middle middle middle middle middle upper middle upper upper class
charleswendy: lower middle middle lower middle lower lower middle lower upper upper middle middle lower lower middle upper class
xavierdick: middle middle middle middle middle upper upper lower lower middle upper middle middle lower lower upper upper middle middle class
beajohn: lower lower lower upper lower lower lower middle middle upper lower lower middle lower lower lower lower middle upper upper middle upper upper upper class
bobrichard: upper lower upper lower upper middle upper upper class
patriciajose: lower middle upper class
arnoldrichard: upper class
stanleypeter: middle lower upper upper class
frankdavid: lower upper upper middle lower upper upper lower lower lower upper lower middle upper lower middle class
tomfranz: upper lower middle lower upper middle middle middle upper lower middle upper lower upper lower upper lower upper lower middle upper upper lower middle middle middle lower class
wendyhans: upper upper lower lower middle middle lower lower middle upper lower class
billharry: upper lower lower upper middle lower middle lower lower lower upper class
billluann: lower upper class
karlpati: middle middle upper upper middle lower lower upper lower upper middle lower upper upper lower upper middle middle middle lower upper lower middle upper middle middle class
violetxavier: upper class
tommyjack: middle lower upper upper upper lower lower lower middle upper class
marianbill: lower upper lower lower middle upper upper upper middle upper upper upper lower lower lower lower lower middle upper lower lower upper lower lower upper lower middle class
tommyrich: middle lower middle upper middle upper middle lower middle middle upper middle lower lower lower middle upper upper middle upper middle upper lower middle middle class
deannamonica: lower upper middle lower upper upper lower upper upper lower middle lower upper lower middle lower upper upper lower upper lower class
garycarla: middle upper lower lower middle upper middle upper upper middle lower upper middle middle lower upper lower middle upper upper upper upper lower class
harrystan: middle middle middle upper middle lower upper lower upper middle upper upper lower middle lower upper lower lower lower upper class
jeffjeff: lower upper lower middle middle middle upper lower middle lower lower middle upper upper middle lower upper lower middle class
wendyrick: middle lower upper lower middle upper middle upper upper lower upper upper middle middle lower lower lower upper lower lower upper lower lower middle class
joseed: middle middle upper upper middle middle lower class
luannkarl: lower upper upper lower lower upper lower upper lower upper upper middle middle class
karlxavier: lower lower lower upper middle upper upper class
monicaarnold: lower middle middle middle upper middle middle upper upper upper lower middle class
richardwilliam: middle middle middle lower middle upper middle class
marianbea: lower upper middle lower lower lower lower middle middle middle middle lower upper upper middle class
stanxavier: lower upper lower middle upper middle class
frankjose: middle upper middle class
deannastan: middle upper upper middle middle middle upper lower middle upper lower lower lower middle lower upper lower class
josejeff: upper middle lower upper upper middle lower lower lower upper lower lower middle upper lower middle middle upper middle middle lower middle middle upper class
jeffmary: lower middle lower lower upper upper middle lower upper middle middle middle middle lower upper middle middle middle middle class
suehans: middle middle middle middle lower lower middle middle middle lower lower upper middle upper lower lower lower middle middle upper middle lower lower lower upper lower class
carlapeter: middle upper class
tommarian: middle lower lower lower lower middle upper middle upper upper lower middle upper upper lower middle middle lower middle middle upper lower lower lower middle upper class
tommymark: upper lower middle lower upper middle lower middle lower upper middle lower middle middle lower upper middle lower lower upper class
monapati: lower lower lower upper middle lower upper upper upper upper middle class
stanstanley: lower class
stanjose: middle middle middle middle upper middle upper lower middle lower upper middle lower upper upper upper middle lower lower middle middle lower middle lower upper class
frankfrank: lower middle upper lower upper middle upper lower lower lower lower upper lower upper middle upper upper middle middle lower lower upper lower middle class
jeffwilliam: lower upper lower lower upper middle class
luannstanley: lower middle lower middle upper upper class
frankrichard: lower lower middle upper middle lower upper lower lower lower upper middle upper lower middle upper lower lower middle lower lower class
edanne: lower upper upper upper upper class
patifranz: upper upper upper lower upper middle lower lower upper upper middle middle upper lower lower upper middle middle middle upper middle upper upper class
wendymarian: lower middle upper lower middle middle upper lower lower lower middle upper middle upper middle lower upper lower lower upper middle class
peterbea: upper upper upper middle upper upper upper lower middle lower middle upper middle upper middle middle middle lower lower upper upper upper lower upper upper upper lower class
beapeter: upper middle lower middle middle lower lower upper upper lower class
davidwilliam: upper middle lower upper middle upper lower lower lower lower upper middle middle lower middle middle lower lower class
patriciarichard: lower middle class
carlabill: lower middle upper middle lower lower upper upper upper upper lower middle upper upper lower lower middle lower upper middle middle upper middle upper lower class
harrypeter: upper lower lower lower middle lower lower lower upper middle middle upper class
charlespeter: upper lower middle lower upper upper upper lower lower upper class
rickwilliam: middle lower middle upper lower upper lower upper upper middle class
peterrich: upper middle lower upper middle middle lower class
wendywilliam: upper upper class
suebill: upper lower middle upper lower lower lower upper lower middle upper upper lower middle middle middle middle middle upper lower lower middle class
anneviolet: middle lower middle middle lower middle lower upper upper lower middle lower middle middle middle lower lower upper upper upper middle middle class
josecharles: lower lower upper upper upper lower upper middle upper lower middle lower upper lower lower middle middle lower lower lower middle lower lower lower upper class
mariandavid: middle upper upper middle upper upper lower upper upper upper upper middle upper middle middle lower upper middle lower middle upper upper upper middle upper class
danatom: upper upper upper lower lower upper upper lower middle upper middle middle middle upper upper class
rickarnold: lower upper middle lower upper upper lower upper middle lower lower middle middle upper lower upper upper middle middle upper lower middle lower lower class
tomwilliam: lower lower upper upper lower middle upper middle lower middle lower upper lower lower lower middle middle upper middle middle middle upper class
danatommy: upper upper middle lower middle upper lower upper class
williamrich: lower middle lower lower lower middle class
davidstanley: upper lower lower upper upper upper lower upper upper lower middle lower lower middle upper class
tommystanley: upper lower upper lower upper lower class
rickrich: lower upper lower upper class
luannwendy: lower lower lower upper lower upper class
monatom: lower upper middle lower lower upper lower upper lower middle upper middle upper middle middle middle upper upper middle middle middle middle lower class
edtom: lower lower lower upper middle middle lower lower middle middle lower middle middle lower middle middle middle upper upper lower lower class
mariansue: lower upper middle lower upper upper middle middle upper upper lower middle upper upper lower lower middle upper lower middle middle upper class
richarddavid: lower lower lower lower lower lower middle middle lower middle lower upper middle lower upper middle upper lower middle class
staned: lower middle middle upper middle middle upper upper middle upper middle upper middle middle upper upper lower lower upper class
jackbea: middle upper lower lower middle middle lower lower upper lower upper lower upper middle lower middle lower middle upper upper upper lower upper lower upper class
josetommy: lower middle middle lower lower middle lower lower middle lower upper upper lower lower middle upper lower lower upper lower lower class
franzarnold: middle middle lower class
stanleymarian: lower lower lower lower upper middle middle lower upper class
stanrich: upper middle middle lower middle upper middle upper upper middle lower upper middle class
richstanley: lower lower upper lower upper lower lower lower upper middle middle lower upper middle middle lower middle lower middle lower middle lower middle lower middle class
danakarl: middle upper lower middle middle class
arnoldtommy: upper upper middle upper lower upper lower lower upper class
garywendy: middle upper class
deannaanne: middle upper middle lower middle middle class
richwilliam: middle upper lower lower lower middle middle upper middle class
stanmona: lower upper lower class
richardcharles: middle upper middle upper lower lower upper middle class
karlwilliam: lower middle lower middle middle lower class
frankpeter: upper middle lower lower lower upper middle middle middle lower upper lower upper middle lower middle middle upper middle upper upper lower class
billed: middle upper upper middle lower lower class
richardtom: upper middle middle lower lower class
patimary: upper middle middle lower middle lower lower lower lower middle lower middle middle middle middle upper upper upper middle upper upper upper lower class
annecarla: middle class
jeffluann: lower lower lower lower upper class
deannadavid: middle upper upper upper middle middle upper lower lower lower upper upper lower middle lower middle middle middle upper middle middle middle class
frankxavier: middle lower middle middle upper middle middle lower lower upper lower middle upper lower upper lower middle middle class
richrichard: upper lower upper middle upper lower lower upper upper upper middle upper lower lower middle upper upper lower upper upper upper lower class
franzjeff: middle middle upper upper upper middle middle lower upper middle middle upper middle middle class
jackjeff: middle lower middle lower middle middle upper middle upper middle lower middle lower upper upper middle lower middle upper middle middle upper upper upper lower middle middle class
williammary: upper lower middle lower lower middle middle upper upper upper middle upper upper upper upper lower upper middle middle lower upper upper upper class
tommyhans: upper upper lower middle upper middle upper class
charlestom: lower middle upper lower middle middle lower lower middle upper upper middle lower middle lower upper lower middle upper upper middle upper middle lower class
xavierstanley: upper lower lower lower lower lower upper lower upper middle class
hansmary: upper lower middle middle middle middle middle middle lower middle upper lower middle upper middle upper middle middle upper upper middle class
frankbob: upper lower middle lower upper middle middle upper middle lower class
jeffsue: upper middle class
monicadana: middle upper middle upper middle lower lower middle middle middle lower lower upper class
stanmark: middle middle middle lower class
patitom: upper lower middle middle lower lower lower lower middle middle upper lower upper lower upper middle lower class
jeffcarl: middle lower middle upper upper lower lower upper lower middle upper lower lower middle class
beatommy: lower middle lower middle middle lower middle upper lower middle upper upper class
patriciarick: middle middle middle lower class
hansmark: upper middle upper middle lower middle middle middle lower middle lower lower middle middle lower middle upper upper lower lower lower lower class
bobjose: lower lower upper middle upper upper upper class
jeffrichard: upper lower upper middle lower lower lower middle middle middle upper lower lower upper lower lower class
carlacarl: lower lower lower lower upper upper lower lower upper upper class
williamfrank: middle lower middle middle lower middle upper middle middle lower upper lower middle class
richardrichard: lower upper upper lower class
violetpeter: lower upper upper upper middle upper lower upper upper upper lower upper lower class
richardkarl: middle lower middle upper upper upper middle upper upper upper lower lower lower upper upper lower upper middle upper lower lower upper lower middle upper upper lower class
josemona: middle middle middle upper class
wendyjose: middle middle upper upper lower middle lower class
dickfrank: lower class
billcharles: middle middle lower lower upper middle middle upper lower middle middle middle upper lower middle lower upper class
rickcarl: middle lower class
davidarnold: middle middle middle lower upper upper lower middle middle middle lower upper middle lower upper middle middle middle middle lower middle class
rickjose: lower upper middle upper upper upper upper lower lower middle lower lower upper lower lower lower upper lower middle middle upper lower middle lower middle class
rickjohn: upper lower middle middle middle upper lower upper upper middle middle middle upper lower lower lower upper lower class
violetanne: upper middle upper upper upper upper middle upper lower upper upper lower lower middle upper lower upper lower lower middle upper lower middle lower middle upper middle class
richarnold: lower upper lower upper middle lower upper middle upper lower lower lower middle lower middle lower upper middle lower lower lower upper lower lower class
monawendy: upper middle middle middle lower middle upper class
suemark: lower lower middle upper middle class
karlbob: lower lower upper lower middle upper upper lower upper middle lower lower class
davidpeter: lower lower class
violetdana: middle lower middle class
dickxavier: lower middle upper middle middle upper lower upper middle lower middle class
tommyviolet: lower upper middle middle upper middle lower upper upper middle middle lower lower lower lower middle middle lower lower middle lower lower upper lower middle middle class
markpatricia: upper upper upper upper upper upper lower middle class
franktom: middle middle middle middle upper middle lower lower upper lower lower lower lower lower lower middle lower middle class
davidmonica: middle upper lower lower middle upper upper middle middle lower lower middle lower lower middle middle upper middle class
xavierfranz: middle middle lower middle lower middle middle lower middle upper middle middle middle lower lower lower upper middle upper upper lower class
monicafrank: middle middle lower lower lower upper class
stanleykarl: upper upper upper lower middle lower middle lower lower lower lower middle middle lower middle lower upper middle class
marianfrank: lower middle upper upper lower upper lower upper upper upper middle upper middle upper lower middle lower middle lower middle middle class
stanleysue: middle lower middle lower middle lower middle upper middle lower lower upper middle upper upper lower lower middle upper middle middle upper class
patriciatommy: lower middle lower upper lower upper middle upper upper lower lower lower upper lower middle upper upper upper middle lower middle middle upper upper middle upper lower class
markmonica: upper lower upper upper lower upper lower class
franzluann: upper middle lower lower middle lower class
dicked: upper upper lower middle upper middle lower upper upper upper middle middle upper upper middle upper upper middle middle lower lower middle middle class
danamonica: middle lower upper upper lower lower upper class
richrich: lower middle class
harrybob: middle lower middle upper upper lower upper upper upper middle middle lower middle middle middle lower lower middle lower upper lower lower lower lower upper class
violetdick: upper lower lower lower middle lower lower lower lower lower middle lower lower middle upper upper lower upper lower upper middle middle upper upper upper lower middle class
carljohn: lower lower lower lower lower middle lower middle middle lower middle middle upper upper upper middle lower class
garymarian: middle upper upper lower middle upper upper lower upper middle upper upper class
tomcharles: upper lower upper lower middle middle upper middle middle lower middle upper middle middle lower lower middle middle upper middle upper class
hansxavier: upper upper upper middle lower middle lower lower class
davidtommy: middle class
