1000
karlsue: middle middle middle middle middle middle upper class
sueluann: lower lower middle upper lower middle upper middle middle middle middle class
bobcarla: upper lower class
stanleymark: middle upper middle middle middle lower upper lower middle lower lower middle upper upper upper middle middle upper middle lower upper upper upper lower lower middle class
marianarnold: middle lower lower lower middle upper lower middle middle lower upper middle lower upper middle middle upper lower lower upper upper upper middle class
carlviolet: middle lower middle middle middle upper lower upper middle lower middle lower middle middle lower middle lower lower middle class
stanarnold: middle upper upper lower middle lower lower upper lower lower middle middle lower upper lower upper middle lower middle middle class
deannaharry: lower lower lower lower class
monicafrank: upper upper upper middle lower middle lower middle middle middle upper middle upper upper lower middle lower lower upper class
garyviolet: upper lower class
jackpati: middle upper middle upper upper upper middle upper upper upper lower lower lower lower middle lower class
davidwilliam: middle middle middle lower upper lower upper upper lower upper upper middle upper lower lower middle upper lower class
richrich: middle middle lower lower upper middle middle upper lower lower lower upper middle class
richcharles: lower upper upper upper lower lower middle class
patisue: lower upper class
johnwilliam: middle upper middle upper middle upper middle middle lower middle lower upper upper middle middle lower middle middle middle upper middle middle middle upper class
franzjeff: upper lower lower upper middle lower middle lower lower middle middle upper upper upper middle upper upper upper upper middle upper middle middle upper lower upper lower class
bobcharles: middle upper class
violetdavid: middle lower lower middle lower middle middle lower upper upper lower upper middle middle upper middle upper class
davidcarla: lower upper lower lower middle lower middle lower upper middle upper lower upper upper upper lower middle lower middle lower lower class
anneviolet: middle lower middle lower upper lower middle lower lower middle class
williamarnold: middle lower lower upper lower lower middle class
karlpeter: middle upper upper upper upper lower lower middle lower upper lower lower middle upper class
charlesstan: middle upper lower lower middle middle lower middle lower upper middle middle lower lower upper upper middle upper upper lower class
deannaxavier: upper lower class
stankarl: upper upper upper lower upper upper middle lower upper lower upper middle lower middle upper middle lower upper middle lower middle middle class
franztommy: upper lower lower middle upper middle upper upper middle upper upper middle class
luanndeanna: lower middle lower middle middle upper lower middle class
frankmark: lower upper middle upper lower middle upper upper lower class
carlamona: lower middle lower middle lower upper middle middle lower upper upper middle lower middle upper class
suemark: lower upper lower lower middle lower middle upper middle middle lower middle middle middle lower upper middle upper lower upper middle upper upper lower upper upper upper class
billmona: middle upper middle middle lower upper upper upper upper lower middle upper middle lower middle middle upper middle upper lower lower middle middle upper class
peterstan: lower middle upper upper lower lower lower middle lower middle upper upper lower middle middle middle middle lower middle middle middle lower upper upper lower upper class
monicabill: upper lower lower lower upper middle lower lower middle upper upper middle middle upper middle lower lower upper class
franzdeanna: middle lower middle upper middle class
davidcarl: middle middle lower middle middle middle lower lower middle middle upper middle middle class
dickdana: middle upper lower lower lower lower lower upper upper upper middle middle middle upper upper upper lower upper lower middle middle lower middle upper upper upper class
suemarian: upper lower upper middle upper lower middle middle upper middle middle class
maryrick: upper middle upper middle lower upper upper lower upper class
arnoldmona: lower upper lower middle middle middle middle lower middle middle lower class
marianpatricia: lower middle middle upper upper upper middle upper middle middle lower middle upper middle lower upper upper class
davidanne: upper middle upper lower upper middle upper class
annerick: upper middle upper middle upper lower middle middle lower middle upper lower upper middle class
patriciafranz: middle lower middle lower upper upper class
charlesjack: lower upper middle middle upper upper middle upper lower lower middle class
josemarian: lower lower middle middle upper lower lower upper upper upper middle middle lower middle middle middle middle class
dickwilliam: upper middle lower lower lower middle middle upper upper middle lower lower lower lower middle lower upper upper class
markluann: upper middle upper upper upper upper upper lower middle middle lower lower middle lower upper upper lower class
tommarian: upper upper middle middle upper lower middle upper middle lower middle upper lower middle lower middle upper middle lower upper upper lower upper lower upper lower middle class
garytom: lower class
stanjose: middle middle upper lower middle upper upper lower middle class
marydick: middle upper middle lower lower lower middle lower middle middle lower middle lower middle middle lower lower middle upper lower lower lower class
hansjeff: upper middle upper lower middle middle upper lower lower upper middle lower lower lower lower lower lower lower middle middle upper lower upper lower class
dickanne: upper upper upper upper middle middle middle upper lower middle lower upper upper upper middle lower class
marianjohn: lower upper lower upper class
garyarnold: upper upper middle lower upper upper upper upper lower middle middle upper middle class
josejohn: lower upper middle middle upper upper upper middle lower middle upper lower upper middle middle lower upper upper middle upper class
monamona: upper middle middle upper middle upper lower middle upper upper lower middle lower lower upper middle upper lower lower upper upper upper lower middle lower middle middle class
marydana: middle middle middle class
petermarian: lower lower upper lower middle upper middle lower lower lower lower middle lower upper middle class
peterdavid: middle upper upper middle upper middle upper upper lower lower upper upper upper upper middle middle upper middle lower upper middle middle middle class
arnoldwilliam: lower middle lower lower upper upper upper upper middle lower upper lower middle upper middle upper middle middle middle upper upper upper lower middle lower class
tomwendy: lower class
jackcarla: upper lower lower middle lower middle lower lower upper upper upper middle middle upper upper upper lower middle upper class
jacked: lower lower upper lower lower lower upper middle upper upper upper upper class
violethans: upper upper middle lower lower middle class
frankpati: lower middle upper class
garymarian: middle middle lower lower middle lower lower lower middle upper lower middle middle upper lower middle upper lower lower lower upper upper upper upper lower middle class
annefranz: middle upper middle middle lower middle lower lower lower upper upper middle upper upper lower middle lower lower lower class
xaviermary: upper middle middle middle upper lower middle middle middle lower upper lower lower middle lower lower middle middle middle class
jeffcarla: middle upper upper lower lower middle upper middle lower middle class
charlessue: upper lower lower upper middle middle upper middle lower middle upper middle upper middle class
carlarnold: lower lower middle lower class
bobpati: lower middle lower upper middle upper middle lower upper middle class
garymonica: lower upper lower upper lower middle lower lower upper upper upper middle lower middle upper upper middle class
tomstanley: upper upper middle upper upper middle lower middle lower lower upper upper upper middle lower upper upper middle class
danahans: middle upper middle class
tombea: lower middle middle upper upper middle upper lower middle lower middle class
tommyluann: upper lower upper upper lower upper lower lower upper middle upper middle lower middle middle upper middle upper lower class
jacktommy: upper lower middle middle lower upper lower class
marianpeter: lower middle lower lower lower middle lower lower lower upper lower middle middle upper middle upper upper middle upper lower middle upper upper lower class
sueharry: lower upper lower middle middle middle middle middle upper lower middle middle middle lower middle middle upper lower middle middle lower lower lower upper middle upper middle class
hanskarl: upper upper lower lower middle middle middle class
frankcarla: lower class
richardanne: upper upper middle middle upper upper upper upper middle lower lower lower upper class
monicapeter: upper lower upper upper middle lower lower upper middle middle lower lower lower middle middle lower lower lower lower upper lower lower middle middle lower class
monicawilliam: lower lower upper lower middle middle lower lower lower upper upper upper upper middle lower middle upper lower middle upper upper lower upper class
johntommy: upper class
jeffviolet: upper lower upper upper class
davidpatricia: lower lower lower lower middle upper upper middle class
edjack: lower middle upper lower middle middle upper middle middle lower upper middle lower upper upper lower upper upper lower upper class
jeffanne: lower lower middle middle lower upper lower middle upper upper upper lower middle middle lower middle middle class
danamona: lower middle lower lower lower middle middle class
joserick: middle middle lower upper lower middle upper middle class
richwendy: middle middle lower lower middle lower middle upper lower lower upper lower upper lower upper upper lower upper middle upper middle lower lower lower lower lower middle class
harrycharles: lower lower lower middle middle lower upper lower middle lower lower middle middle upper class
violetmarian: lower lower middle upper lower middle lower lower lower upper upper upper middle middle lower middle upper upper upper class
peterjeff: middle middle middle middle middle lower lower lower middle lower middle lower lower middle lower lower class
jackrich: lower lower upper upper lower middle upper middle upper middle middle upper upper upper middle upper upper lower middle lower middle middle class
joseluann: lower lower lower class
markdeanna: upper lower middle upper middle upper middle lower upper lower middle middle lower lower class
markdick: middle upper lower class
monicajeff: upper middle middle middle middle upper lower lower upper middle upper upper upper upper upper upper middle upper middle middle lower middle upper middle upper lower middle class
deannadeanna: middle middle upper lower middle upper upper middle middle lower lower lower class
garydana: middle lower upper class
monicafranz: middle lower upper upper lower middle lower class
franzwilliam: lower upper lower middle class
luannsue: upper lower class
harryrich: upper lower lower class
hansrichard: middle lower middle middle lower middle lower class
stansue: lower upper middle lower upper middle upper middle upper upper middle middle upper upper upper middle lower upper middle lower lower upper class
monawilliam: middle middle class
dickjohn: middle middle upper middle lower lower upper upper lower middle middle middle middle upper middle lower middle middle upper middle lower upper lower class
jackxavier: lower lower upper lower middle lower upper middle class
billbea: middle lower lower middle upper middle lower lower upper middle upper lower middle middle class
karlanne: upper upper class
karlfranz: lower middle upper lower lower middle upper middle lower lower upper class
annewendy: lower lower middle upper lower upper middle class
arnoldwendy: upper lower middle upper lower lower lower upper upper lower middle middle middle lower lower lower middle class
peterhans: lower upper lower middle lower lower middle upper upper middle middle lower upper middle class
franzmark: upper middle lower upper lower middle middle middle middle upper upper upper lower upper lower middle upper lower lower lower lower middle lower upper upper upper class
karltommy: upper upper middle upper upper lower middle lower class
tomanne: middle middle upper upper middle upper lower middle middle lower upper middle lower upper class
bobpatricia: lower middle lower lower lower lower middle upper lower middle middle lower middle middle middle lower upper upper class
stanleycharles: middle upper upper lower upper lower upper upper lower lower lower middle upper upper middle middle lower lower middle upper upper middle lower class
suexavier: upper lower middle middle upper upper upper class
garymark: middle middle lower middle upper upper upper class
tommonica: lower middle lower lower middle middle middle middle upper upper middle middle class
franztom: lower middle middle middle upper upper lower upper upper middle lower class
dickbea: upper lower middle middle upper lower middle middle lower middle lower lower class
davidfranz: middle middle upper upper class
tomkarl: middle lower middle upper lower lower middle middle upper middle upper upper class
monicahans: lower middle lower lower class
hansjose: middle upper middle lower upper middle upper lower lower lower class
peterbea: middle lower lower upper lower lower upper lower upper upper upper lower upper middle lower middle middle middle lower upper class
hansdavid: upper lower upper middle class
charlesharry: lower lower middle lower lower class
franzbill: middle middle lower lower lower upper lower lower upper lower upper middle upper lower middle middle upper upper middle upper class
karlarnold: upper middle middle lower lower lower upper lower lower upper upper middle lower upper middle middle class
patriciajack: upper lower middle lower middle upper lower middle middle middle upper lower upper upper middle lower lower middle upper lower upper middle middle middle class
jefftom: upper middle upper middle middle upper lower middle upper upper middle lower lower middle lower lower lower lower middle lower lower upper upper upper middle middle class
williamtom: lower lower upper middle upper lower upper upper middle middle class
johnsue: upper middle lower middle lower lower middle middle upper upper middle upper lower lower middle lower middle lower class
monahans: upper upper class
jeffmark: lower upper lower lower lower middle upper upper middle middle upper lower lower upper lower upper upper class
jackcharles: lower lower upper lower upper lower lower middle class
beapati: lower upper lower upper upper middle upper middle lower middle lower middle middle upper middle middle upper lower middle lower lower class
harryviolet: middle middle lower lower upper middle lower middle lower upper middle lower class
josebob: lower lower upper upper lower middle lower middle middle lower upper upper lower upper lower class
richardtommy: middle middle middle upper upper upper lower lower middle middle upper middle middle upper class
edmona: middle lower lower upper upper middle middle upper middle lower lower upper lower lower middle upper upper middle class
patricialuann: lower upper lower middle lower upper lower lower lower class
hansarnold: upper lower middle upper lower lower middle lower class
karlmary: lower upper upper lower middle upper upper upper lower class
tommydana: lower middle lower upper class
suetommy: middle upper upper lower lower upper middle lower lower middle upper upper upper middle middle middle middle lower upper middle lower middle upper lower class
charlesbea: lower lower lower middle upper lower upper middle class
jackwendy: lower upper upper upper lower lower middle middle lower upper middle middle lower lower lower middle class
mariantom: upper upper middle middle lower upper upper upper lower upper middle middle upper lower lower upper class
daviddana: lower lower lower lower lower upper upper middle lower upper upper middle upper lower lower middle middle middle lower middle middle upper upper middle class
johntom: upper lower middle upper lower upper lower upper middle upper upper lower middle middle lower upper lower upper upper middle lower class
jackgary: middle upper lower lower middle lower upper lower middle middle lower class
monamark: middle upper upper middle middle upper middle middle lower upper upper upper class
tomgary: lower upper upper middle upper lower lower middle middle upper upper upper upper class
charlesmonica: lower middle class
billdeanna: lower lower lower lower lower upper upper upper middle middle upper middle middle middle middle upper lower middle lower middle upper upper upper lower middle upper middle class
richrichard: upper upper lower upper middle middle middle upper middle lower upper upper upper upper middle upper lower upper upper class
deannadavid: middle middle middle lower upper lower upper upper upper lower upper upper lower middle upper class
deannatommy: lower lower middle middle upper upper middle middle upper upper middle class
frankrich: lower upper lower middle lower middle middle upper upper middle middle middle upper lower lower lower lower class
luanncarla: lower middle middle upper upper middle upper lower upper middle middle upper upper lower upper lower middle upper class
carlstan: upper middle lower lower middle upper lower upper lower lower middle lower middle lower upper lower upper upper lower middle lower lower middle lower class
karljack: lower upper middle upper upper class
patriciabea: lower middle lower middle lower upper middle upper lower lower lower middle upper lower lower lower middle upper middle upper upper upper lower upper lower lower class
stanleymona: middle upper upper lower lower upper upper upper lower upper middle lower upper upper class
karlmark: lower lower middle class
dickstan: middle upper middle upper lower middle lower middle class
violetdeanna: lower upper lower upper lower lower lower upper middle middle lower upper middle lower middle middle middle middle lower class
tomjose: upper upper lower middle middle lower middle upper upper middle middle upper class
marybill: upper upper class
peterpatricia: lower lower upper middle upper middle lower middle upper middle upper upper middle upper lower lower lower upper lower lower middle middle lower middle class
edwendy: lower upper middle middle upper class
dickpati: lower lower lower middle middle upper upper upper upper class
carlafranz: lower upper middle upper upper upper middle upper upper middle middle lower upper lower lower middle class
dickrich: upper middle middle middle lower lower upper upper middle lower upper middle upper middle upper upper upper middle middle middle upper middle lower lower upper upper class
marycarl: upper middle lower middle upper middle class
patijose: middle lower lower middle middle lower middle lower upper upper lower middle lower lower lower middle middle class
monicajack: lower upper lower middle upper lower middle upper upper upper upper upper upper upper lower middle upper middle middle upper middle lower lower middle middle upper class
carlamark: middle middle lower upper middle upper lower upper upper lower lower middle middle middle middle upper upper middle upper middle upper lower middle upper class
wendyjeff: lower lower upper lower middle upper middle middle middle upper lower middle lower middle upper middle middle lower lower middle lower class
xaviergary: upper middle lower upper upper middle class
marianrich: upper upper lower middle lower upper middle upper lower upper upper lower lower upper middle upper class
jeffkarl: middle class
annetom: lower upper lower upper upper upper class
karlcarla: middle lower lower upper upper lower lower upper middle upper lower lower lower middle upper lower middle lower middle lower upper upper lower lower upper lower class
monarichard: lower lower upper upper upper upper lower lower middle lower middle lower upper lower middle middle middle middle middle upper middle middle upper middle upper lower middle class
carlabill: middle upper middle middle middle class
charlesdeanna: lower upper middle middle lower class
williamdeanna: upper upper lower upper class
sueanne: middle upper upper upper lower class
danafrank: lower middle upper middle lower middle middle upper upper lower lower lower upper upper middle upper lower lower class
peterxavier: lower lower middle lower middle lower middle middle middle middle upper upper upper class
jefftommy: middle lower lower upper lower upper upper middle upper upper lower middle middle upper middle middle lower upper class
wendyharry: middle lower lower upper upper class
edharry: lower upper lower lower upper lower middle upper middle lower middle class
peterfranz: middle upper class
richardgary: upper lower middle upper lower middle lower middle upper class
wendymona: upper lower class
davidpeter: upper lower upper middle lower upper middle lower upper upper upper upper middle middle upper lower middle middle upper upper upper class
wendymark: middle lower middle upper middle lower lower upper middle upper middle lower class
bobjohn: upper upper upper middle upper middle upper class
karlwendy: lower middle middle middle upper middle lower upper upper lower upper lower upper upper middle upper upper upper class
richjeff: middle middle lower upper lower upper upper upper middle upper middle middle middle upper middle middle lower upper lower lower upper upper upper lower lower middle middle class
patifranz: upper upper middle upper middle lower lower upper middle upper lower middle lower middle middle upper lower upper upper middle lower lower upper middle class
markharry: middle lower upper middle middle lower middle upper middle upper middle middle class
petercarla: middle middle upper lower class
patriciaanne: lower middle upper upper upper upper upper middle middle middle upper class
richardfrank: lower lower upper middle middle upper middle upper upper middle lower upper lower middle middle middle lower upper class
franzpati: upper lower upper middle lower lower middle middle lower lower lower upper lower upper middle middle middle lower upper middle lower middle middle middle lower class
frankstan: lower lower middle upper middle lower middle lower lower lower middle lower upper middle upper lower lower lower middle lower class
tommycarla: lower lower middle upper upper lower middle middle upper upper middle middle lower middle middle middle lower middle upper lower lower lower middle middle class
karljohn: middle lower upper upper middle middle upper middle middle lower middle lower middle upper lower lower upper upper lower middle middle lower upper lower upper upper lower class
danaluann: middle middle lower upper middle middle lower lower middle upper middle lower middle middle lower upper middle lower upper upper upper class
jeffdeanna: upper lower lower upper middle lower upper upper upper upper upper upper middle class
carlanne: lower upper upper upper middle middle middle lower upper lower lower upper lower upper middle middle middle lower lower middle lower upper upper class
richardpati: lower upper lower class
hansdeanna: upper middle lower lower lower upper lower middle middle middle middle upper lower middle lower upper lower lower upper middle middle upper lower middle upper upper middle class
hanspatricia: upper middle lower middle middle lower lower upper middle lower upper lower middle middle upper upper lower middle lower class
marysue: lower upper lower upper upper lower class
anneanne: upper lower lower middle upper middle lower lower upper middle middle lower class
richdavid: upper lower middle lower class
jeffbob: middle upper upper middle class
josepati: middle upper lower upper middle middle lower lower middle upper lower lower upper middle lower middle middle lower lower upper middle middle upper lower middle middle lower class
richardwendy: upper middle upper middle middle upper middle middle upper class
marianbill: lower lower middle lower upper lower upper lower upper upper middle middle upper class
frankfranz: upper lower lower upper middle lower upper lower lower middle middle middle upper upper middle lower middle middle middle upper upper upper upper class
deannapati: upper upper upper middle upper lower lower middle lower lower middle middle upper middle middle middle lower middle class
carljeff: upper middle lower lower middle middle middle middle lower upper middle lower upper lower middle lower lower lower upper lower middle lower lower upper lower middle lower class
rickmona: lower middle lower middle middle middle lower lower class
johnpatricia: middle lower upper upper lower lower upper upper upper upper upper upper middle middle upper upper upper middle middle lower lower upper upper upper class
patriciabill: middle upper middle middle lower lower upper upper upper upper middle lower middle lower upper upper upper middle middle class
beapeter: middle upper lower middle class
stanleybob: lower lower lower upper middle lower middle lower upper upper middle upper middle middle lower middle middle upper middle lower lower lower upper lower middle class
marianxavier: middle upper middle middle upper upper middle lower upper middle middle upper upper class
xavierviolet: middle lower class
xavierrich: upper middle upper upper lower lower lower upper upper lower middle lower middle upper lower lower upper lower middle middle upper lower middle middle class
williamdana: upper lower lower middle lower middle lower lower middle lower lower lower middle upper lower middle middle lower middle middle lower lower middle upper class
markstanley: upper middle middle lower upper lower middle class
daviddavid: lower lower lower lower middle class
wendyfranz: lower lower upper upper upper middle upper upper upper class
garyanne: upper upper middle upper lower lower upper lower lower upper lower lower upper middle lower lower lower upper middle lower middle middle lower lower middle middle middle class
karljose: upper upper middle lower lower middle lower lower upper upper lower lower middle upper middle middle lower upper upper upper upper middle middle class
carlrich: upper lower lower upper upper middle upper class
patriciacarla: lower middle lower lower lower upper lower lower middle lower lower lower middle middle lower upper lower lower class
violetkarl: middle lower lower upper lower upper upper class
xavierjack: lower middle lower middle lower class
karlbob: lower upper lower middle middle upper upper middle upper lower lower lower lower middle lower lower lower lower lower middle class
staned: middle middle lower lower middle lower upper middle middle upper lower middle middle upper upper upper lower middle lower lower lower class
johnbill: middle upper upper lower upper upper lower upper middle lower upper middle middle middle middle upper middle middle upper upper middle lower middle class
frankwilliam: upper upper lower middle middle upper lower middle lower upper lower upper middle lower middle upper upper class
stanleytom: middle middle lower middle upper upper middle lower class
jeffpeter: upper upper middle middle middle middle upper middle upper lower middle upper upper middle upper lower upper upper lower middle class
marianjose: lower middle lower lower middle middle upper lower middle middle lower lower middle middle lower upper upper middle upper lower upper upper middle middle upper class
carlamary: middle upper upper lower lower middle upper middle middle middle lower upper upper lower lower lower upper lower upper lower upper upper middle upper lower class
violetfranz: upper upper upper lower lower lower upper upper upper upper upper middle lower middle upper upper middle upper middle lower middle upper middle upper middle middle class
deannadana: upper middle upper upper lower middle class
frankxavier: upper upper upper middle lower middle upper middle lower class
charlesjose: upper lower middle lower middle lower upper class
bobluann: lower upper lower lower lower middle middle upper lower middle middle upper middle lower upper lower middle upper upper upper class
richdeanna: upper lower upper upper upper middle middle upper middle upper lower lower middle upper upper upper upper middle upper middle upper upper middle lower class
edmonica: lower upper middle upper middle middle upper lower middle middle middle upper upper upper upper lower class
violettom: upper middle upper middle middle lower class
marymark: upper middle middle lower lower class
johnjeff: middle upper lower middle upper upper upper lower lower upper lower lower middle lower middle upper upper class
billcharles: middle lower upper lower upper lower upper lower middle upper lower upper upper upper upper lower lower lower lower lower lower lower middle middle lower middle class
tommykarl: upper class
davidhans: upper middle middle upper lower middle upper lower upper lower upper middle upper lower middle middle upper upper lower lower class
frankdeanna: middle lower lower upper middle upper middle middle middle upper middle middle middle middle upper middle upper lower class
petergary: middle middle class
josetommy: lower middle middle middle middle class
frankmonica: middle upper lower middle upper upper middle upper lower upper middle upper middle middle lower upper lower middle lower middle lower lower upper lower middle class
deannapatricia: upper class
harrydavid: lower middle middle lower lower lower lower lower lower upper middle lower lower middle middle middle middle upper lower middle lower upper middle upper middle upper class
rickkarl: middle middle lower upper middle upper lower upper upper upper upper class
mariandeanna: upper middle middle upper lower lower lower upper upper lower upper middle upper upper lower class
edarnold: lower upper middle lower upper lower middle lower lower upper lower lower lower lower lower upper middle lower upper lower lower upper lower upper upper upper upper class
monaharry: upper middle lower class
markstan: lower upper lower middle class
johndana: lower middle lower middle middle middle middle middle lower upper middle middle lower middle class
carlcarl: middle middle middle lower lower lower lower upper middle lower lower middle upper lower lower middle middle middle lower lower class
richsue: upper upper upper lower upper lower upper lower lower lower upper lower lower middle upper upper lower middle lower middle upper lower upper middle middle upper class
josejack: upper class
markfranz: middle middle middle lower middle lower middle middle middle middle upper upper upper lower upper upper middle middle middle middle middle lower upper upper upper lower upper class
tommydeanna: lower lower middle upper upper upper middle lower upper lower upper lower middle upper upper lower lower upper lower lower middle class
violetstan: lower upper middle middle middle upper upper upper lower upper lower middle lower upper middle lower upper middle lower lower lower upper middle lower lower upper lower class
xaviermark: upper class
markrichard: middle middle lower lower upper lower upper middle lower lower upper middle lower upper upper lower lower lower upper upper class
edmark: middle middle upper upper lower upper middle lower upper upper upper class
dickwendy: middle upper upper middle middle lower lower lower middle lower lower upper middle middle upper lower lower lower middle lower upper lower middle upper class
harrymarian: upper middle middle lower lower upper upper lower upper class
harrybill: middle lower upper lower lower middle middle upper lower upper lower middle middle lower middle upper class
franzharry: lower upper middle middle lower middle middle upper middle upper upper middle lower upper middle middle upper middle lower upper lower lower upper lower upper upper class
edbob: middle lower upper middle middle lower upper lower upper lower middle lower middle lower lower lower middle middle lower lower middle lower middle middle upper upper class
eddavid: middle lower lower upper upper upper upper upper lower middle lower upper upper middle middle lower lower lower upper upper upper middle lower class
davidviolet: middle lower lower lower middle upper lower middle upper middle middle middle middle lower middle middle upper upper lower lower lower class
williamwilliam: lower middle middle middle middle middle middle lower upper middle upper lower lower upper lower middle upper middle lower middle class
beajack: lower lower upper lower upper upper lower middle middle lower upper middle upper middle upper middle upper upper middle lower upper class
stanstan: lower middle upper middle lower upper lower upper middle lower upper middle lower lower upper upper lower class
williamfranz: upper class
monicadick: middle upper middle upper upper middle lower lower lower upper upper upper lower lower lower middle middle middle class
arnoldjeff: lower middle middle upper middle middle lower upper lower middle upper middle upper upper middle upper upper lower lower upper middle upper class
xaviercharles: middle lower lower middle upper upper lower upper upper middle upper class
rickpeter: upper upper middle middle upper upper middle upper lower middle lower middle upper middle class
luannstan: lower upper lower lower middle lower lower upper lower lower middle middle middle lower middle upper lower upper class
danawilliam: upper upper lower middle middle middle class
maryhans: upper lower middle upper upper class
danaharry: middle class
monarick: upper upper upper upper upper middle middle middle upper upper middle lower lower upper upper upper upper upper upper upper upper lower class
dickbob: upper lower upper lower lower middle middle lower middle upper middle upper upper upper class
annejohn: middle lower middle upper upper middle upper upper lower upper middle middle upper upper middle lower lower upper upper middle middle middle middle middle upper class
deannacharles: middle middle lower upper lower upper lower lower lower middle lower middle middle middle lower upper middle middle upper lower middle middle upper class
monicadeanna: upper middle upper upper upper lower upper middle upper middle lower lower upper lower upper middle class
franzkarl: upper lower middle middle upper lower upper upper lower middle upper upper upper upper lower upper middle lower middle upper lower lower lower upper upper middle middle class
harrystan: middle middle lower upper upper upper upper middle lower upper middle upper middle lower middle upper upper upper lower upper upper lower upper upper class
markpati: middle upper lower middle upper upper middle lower middle lower upper lower upper lower upper upper middle upper lower middle lower lower upper class
tomdeanna: upper upper middle middle lower lower class
petercharles: upper middle class
josecarl: middle lower upper upper middle middle middle lower middle middle middle upper upper upper middle upper middle lower upper middle upper lower lower middle upper lower class
beamary: lower lower lower upper upper middle lower lower lower lower lower lower middle middle middle upper class
monakarl: middle upper lower middle middle lower lower lower upper middle lower upper upper upper middle middle lower lower middle upper middle upper middle lower upper class
davided: upper middle lower middle middle upper lower middle lower middle upper middle upper middle upper middle class
carlarichard: lower class
williamsue: lower upper upper middle upper lower middle middle middle lower middle middle middle upper middle middle lower upper lower class
garyjose: upper upper middle middle lower upper lower middle upper lower upper lower lower middle middle class
danajeff: upper lower upper middle upper upper lower middle upper lower upper lower upper middle upper middle upper middle lower upper lower class
suefrank: lower middle upper middle middle middle upper class
harryrick: upper lower lower upper lower lower middle middle lower lower middle middle lower lower lower lower middle middle lower lower upper middle upper middle class
carlapati: lower upper lower lower lower upper lower lower lower lower middle lower upper middle lower upper lower lower class
deannapeter: middle middle lower middle middle upper middle middle upper upper middle upper upper lower lower upper upper lower class
charlespatricia: upper upper middle upper lower middle lower lower upper lower upper lower lower middle upper lower lower upper middle middle middle lower middle upper middle class
williamanne: lower middle upper middle lower upper lower middle middle middle lower upper lower lower lower middle upper lower lower middle upper middle lower class
deannacarl: upper upper middle middle middle lower upper middle middle lower upper lower upper upper lower middle upper lower middle upper middle lower middle class
tomjohn: upper lower class
deannamonica: middle upper lower middle upper middle upper upper lower upper upper upper upper upper upper lower middle lower middle middle upper lower upper class
deannabob: upper lower lower lower middle lower upper middle lower class
violetmonica: middle upper lower middle lower upper middle middle lower middle middle lower lower upper middle upper class
patipeter: lower lower middle lower lower lower middle lower lower middle lower lower class
davidstan: middle lower lower lower middle lower lower upper middle upper middle lower upper upper upper lower upper lower lower lower lower lower upper class
johnstanley: upper lower middle upper middle class
josefranz: lower middle lower upper middle upper lower lower upper lower middle upper lower middle upper lower middle upper middle middle class
xaviersue: middle upper upper upper upper upper upper middle middle lower lower upper lower lower middle lower upper upper lower upper middle lower middle middle upper lower class
harrytommy: upper upper middle middle upper middle lower middle middle class
davidjeff: upper class
karltom: upper class
marianwendy: middle lower middle upper middle middle middle middle middle upper lower upper middle lower middle upper middle upper lower lower upper upper upper class
jeffrich: upper lower lower middle middle upper upper lower upper middle lower middle upper middle middle middle upper upper upper lower middle upper middle upper middle class
tomdana: middle lower lower middle lower upper middle middle upper middle upper upper class
rickviolet: lower middle lower lower lower middle upper upper lower upper upper lower middle middle lower lower lower middle lower upper lower lower upper class
charlesjohn: lower middle middle upper middle middle lower middle middle lower middle class
williamstanley: middle lower upper middle lower upper middle upper lower lower middle middle lower upper upper lower middle lower lower lower upper middle middle lower lower middle class
beaharry: lower lower lower upper upper lower upper lower upper middle middle lower middle lower lower middle lower lower middle lower middle middle middle lower middle class
annerichard: upper middle lower middle lower lower middle upper lower lower lower upper upper middle lower lower class
peterdana: middle middle lower upper upper upper upper upper lower class
maryfranz: lower middle upper lower lower middle upper class
jackjohn: lower lower upper middle upper upper lower upper lower upper lower upper middle upper middle upper middle lower middle class
carlcharles: middle middle middle upper upper middle class
peterjose: lower upper upper upper upper lower lower lower lower upper upper upper lower lower class
carlsue: lower middle upper middle upper upper middle upper middle lower class
patimonica: lower middle lower lower upper middle middle middle upper middle lower upper middle lower lower upper class
charlesfranz: upper lower upper middle middle lower middle middle middle lower lower upper middle class
monicarichard: lower lower middle upper lower middle middle lower upper lower upper lower lower upper upper middle upper middle middle upper class
carlaxavier: upper middle upper lower lower upper middle upper middle lower upper upper upper lower lower lower middle middle middle middle middle lower lower upper class
annepatricia: middle lower upper lower upper upper upper lower middle lower upper upper lower upper middle lower upper middle upper upper lower middle middle middle class
frankbob: upper middle upper upper lower lower middle middle middle upper lower lower upper class
monagary: middle lower upper lower lower middle lower middle upper middle upper lower upper upper middle upper lower lower middle lower lower upper middle class
deannajack: upper middle upper middle middle middle class
johnrich: middle upper lower lower upper lower upper upper lower lower middle upper class
frankdana: upper upper lower lower middle middle class
violetjohn: upper lower lower lower middle middle upper middle middle middle upper upper middle class
suebea: middle lower lower upper lower upper upper middle lower middle class
suestanley: middle upper middle lower middle upper middle upper upper lower lower upper upper middle lower lower lower lower upper class
bobtom: upper upper middle upper middle upper upper lower middle upper middle upper middle upper lower upper middle upper upper lower lower lower upper lower middle class
williamfrank: lower upper lower upper class
annemona: middle middle lower lower middle upper middle class
luannjack: middle middle middle upper lower middle lower lower middle lower middle upper lower upper lower class
richardmona: lower lower lower lower upper lower lower lower upper upper lower middle upper class
richhans: middle upper middle upper middle middle middle middle middle class
tommyharry: upper lower upper lower lower lower lower lower upper lower middle lower lower lower lower lower class
tommypati: upper middle upper upper lower upper lower upper lower lower lower middle class
xaviertommy: middle middle upper upper middle class
marianstan: lower upper middle middle middle middle upper lower upper middle lower middle upper upper middle middle middle upper upper lower middle lower upper upper lower middle class
harrycarla: lower upper middle middle middle middle middle upper upper upper upper upper upper middle middle middle lower upper upper middle lower lower middle lower lower lower class
tommyrichard: upper lower middle upper upper middle middle lower middle lower lower lower lower lower lower lower lower middle upper upper upper middle lower middle middle upper class
marianwilliam: middle upper lower lower middle class
violetjack: upper class
jacksue: upper lower upper class
daviddeanna: lower lower middle class
arnoldtommy: upper upper lower middle middle lower middle upper lower lower lower upper upper upper lower middle lower upper middle middle middle upper middle upper middle lower class
peterbill: middle middle lower middle lower lower class
annemark: upper upper lower upper lower middle middle upper lower upper upper middle middle lower upper lower lower middle upper upper lower middle class
markkarl: upper upper middle lower lower middle middle middle upper lower lower upper lower lower class
annedeanna: upper lower lower middle middle upper lower lower middle upper upper middle middle middle lower middle middle upper upper class
marymona: lower upper middle upper middle upper middle lower middle lower class
carlawilliam: upper lower upper upper lower lower lower lower lower middle upper middle lower middle upper upper middle lower lower middle upper upper lower lower middle upper class
petermona: upper middle lower middle lower lower upper lower class
rickdeanna: lower upper middle lower upper upper upper upper middle middle upper lower class
rickluann: middle lower lower middle upper middle middle lower lower upper upper lower upper middle class
stanrichard: middle lower middle middle upper lower upper middle upper middle upper class
annehans: middle lower upper lower middle middle upper middle lower middle lower upper middle middle lower middle lower lower lower lower upper upper upper class
sueed: upper lower upper upper lower lower upper middle middle middle upper middle middle upper middle upper upper middle upper lower upper middle upper upper middle lower class
beamona: lower middle middle middle upper middle upper lower lower lower middle middle upper upper middle upper upper middle middle upper lower lower middle middle middle lower middle class
anneharry: upper middle upper upper lower middle upper middle upper upper upper lower middle class
williamjack: lower middle middle middle middle middle upper lower middle middle upper lower middle lower middle middle middle middle middle lower middle middle middle upper upper upper upper class
carlabob: lower middle lower upper lower middle lower lower upper lower upper middle middle middle middle middle middle middle lower middle upper lower class
patirichard: lower upper middle lower class
karlpati: upper upper upper upper upper upper upper lower upper lower middle middle lower lower middle class
xavierjose: middle middle middle middle middle middle lower middle lower middle class
richardxavier: middle upper middle class
garystan: upper upper upper middle middle upper lower lower class
luannjose: upper lower lower lower upper lower middle lower middle middle upper lower lower upper lower class
tommytom: lower upper upper lower upper upper upper upper upper middle upper class
beaed: upper upper upper middle middle upper middle middle upper middle middle lower middle middle upper lower upper lower middle lower lower class
patitom: middle lower middle upper middle upper upper lower upper lower lower middle class
annemonica: lower middle lower upper upper lower upper middle lower middle lower lower lower middle upper lower middle upper lower middle lower upper class
billjose: upper class
jackstanley: lower middle middle lower lower middle upper upper middle lower middle upper lower lower upper middle lower middle middle middle middle middle lower class
suefranz: middle upper lower middle middle upper upper upper middle lower middle middle lower lower middle lower lower upper lower upper lower middle middle middle upper class
garyharry: upper middle upper lower middle lower lower lower lower lower upper lower middle upper lower middle lower lower lower middle class
joseed: lower upper middle lower middle lower middle middle upper middle lower upper middle middle middle class
stanleyluann: lower upper middle lower middle lower middle upper upper middle lower upper upper middle lower lower middle middle upper upper middle middle middle class
rickjeff: upper middle lower upper lower lower middle middle lower middle lower upper lower lower middle middle upper lower lower middle middle upper lower upper upper upper class
frankwendy: upper upper upper upper upper middle lower lower lower upper upper lower lower upper lower middle upper upper lower middle lower middle upper class
carlbob: middle middle lower lower upper lower middle lower middle upper middle lower middle class
stancarl: lower middle middle middle middle lower lower lower middle middle upper upper lower upper middle class
peterdick: lower upper middle middle lower upper lower upper class
franktommy: upper middle middle middle lower middle upper upper middle lower lower lower upper lower lower lower middle lower class
davidjose: lower middle middle upper middle upper middle middle upper lower middle lower middle upper class
luannharry: lower class
rickjack: upper upper middle middle upper upper lower middle upper lower upper upper upper middle upper lower lower middle class
marydavid: middle lower upper middle lower lower upper lower upper upper lower upper middle upper middle lower upper lower middle middle lower middle upper lower class
suemona: upper middle middle lower class
suecarla: middle lower upper upper lower lower middle middle lower lower lower upper lower lower middle lower upper upper middle middle lower middle middle middle class
arnoldrich: middle upper upper lower middle lower lower lower lower middle upper upper upper upper middle class
bobbea: lower middle lower lower upper class
richardwilliam: lower upper upper lower lower middle class
tommyed: middle upper lower lower upper middle upper middle upper middle lower lower lower middle middle class
stanpeter: middle upper upper lower middle middle upper middle upper lower middle middle upper middle lower upper middle lower upper upper lower lower middle lower class
franzbob: middle lower lower upper lower middle upper middle middle upper middle middle upper upper lower middle lower lower upper upper class
monicacharles: lower upper middle upper lower lower upper lower upper middle upper middle class
beajose: upper middle upper middle lower lower lower middle upper lower middle middle middle lower lower class
deannaed: upper upper class
richardluann: lower lower upper lower lower middle upper lower class
beapatricia: lower upper middle lower upper lower middle middle lower middle upper lower upper middle lower middle middle lower middle upper lower lower upper middle upper lower class
danarick: upper lower upper middle upper lower lower middle upper upper middle middle middle middle upper lower lower middle upper middle middle lower upper lower lower middle middle class
marianharry: lower upper upper class
franzstanley: upper lower lower lower upper upper upper upper lower lower lower lower lower upper middle upper lower middle middle class
beabill: lower upper lower middle class
wendysue: middle upper lower upper lower middle lower upper lower middle lower lower upper upper lower middle lower middle lower upper middle middle class
stanwendy: middle lower lower lower upper upper lower lower lower lower upper lower lower lower middle middle upper middle upper middle class
patriciahans: middle upper middle lower middle upper upper lower middle lower middle middle lower lower middle upper middle upper middle middle lower upper middle upper lower class
tommyjohn: lower class
beafrank: upper middle lower middle middle lower upper upper middle middle upper lower middle middle upper middle upper middle lower upper class
jackmona: lower lower upper middle middle lower middle lower lower lower upper upper upper upper lower middle middle class
patriciatommy: middle lower lower class
patriciatom: middle upper upper middle lower lower lower middle lower upper lower middle upper lower upper lower middle upper lower lower class
richardrick: upper lower upper lower upper middle class
johnarnold: middle lower lower middle lower upper upper lower lower upper lower lower middle lower upper middle middle class
billgary: lower middle lower middle upper upper middle upper upper middle middle upper middle class
monajose: middle lower lower middle middle upper upper middle lower middle lower upper lower middle middle upper upper middle upper middle lower lower middle lower lower class
harryjeff: upper lower class
jeffwendy: lower middle middle lower upper upper lower upper upper upper middle upper lower upper middle lower upper class
marianmark: upper lower upper middle lower upper upper middle middle middle lower upper upper lower lower lower upper middle upper class
tommycharles: lower upper middle upper lower upper upper lower middle upper lower upper middle upper upper upper lower lower lower middle class
wendycarl: lower middle lower middle class
violetcharles: middle upper middle lower lower lower middle upper middle lower upper middle upper upper middle upper middle lower middle middle lower class
monacharles: lower upper middle lower lower lower middle lower upper upper upper lower middle middle upper lower upper middle upper class
tommymarian: upper middle upper upper lower lower lower middle class
stanleyxavier: middle middle lower upper upper lower lower upper middle middle upper middle lower lower middle lower lower middle upper upper middle upper lower class
dickmona: upper lower middle middle upper lower middle middle upper middle middle upper lower lower middle middle upper lower middle lower middle middle upper lower class
frankharry: middle lower middle lower middle middle lower upper lower upper middle lower middle upper upper upper upper lower lower middle upper class
frankcarl: lower lower upper lower upper middle middle lower upper middle class
charlesbob: middle upper lower upper upper lower upper upper middle middle middle middle lower upper upper upper lower middle class
arnoldmary: lower lower lower upper lower lower middle middle lower lower upper lower lower lower upper middle middle upper upper middle lower middle class
harrymona: lower upper lower lower lower middle upper upper middle upper lower lower class
hansmonica: lower middle upper lower upper lower lower lower lower lower middle lower upper class
johnjohn: upper lower middle lower lower upper middle upper class
franzjack: upper middle lower class
luanndavid: middle lower middle upper lower middle lower lower lower middle middle lower lower lower lower upper middle lower upper lower middle middle middle middle upper lower upper class
mariancarla: middle upper upper middle upper middle upper lower lower upper middle middle upper middle middle upper lower middle lower class
violetjose: middle lower middle class
josepatricia: upper upper lower middle middle lower upper middle upper middle middle lower middle upper upper upper lower middle upper middle lower middle middle middle lower class
markdavid: lower lower middle upper upper upper lower lower lower middle upper lower middle middle middle upper upper lower lower upper lower upper upper lower middle class
jackwilliam: middle middle middle class
williamtommy: middle upper upper middle lower middle upper upper lower upper middle lower lower lower class
jeffhans: lower lower upper class
arnolddeanna: upper upper class
frankjohn: middle middle lower lower lower middle middle middle upper middle upper upper lower upper middle lower middle middle upper middle middle lower upper class
jackbill: upper upper lower middle middle lower upper lower middle middle upper upper middle lower lower upper upper upper middle middle upper lower middle middle middle lower upper class
johnmark: lower lower lower middle lower upper lower lower upper upper class
maryfrank: lower lower lower lower middle middle upper lower middle upper lower upper lower class
hansmona: lower upper middle upper upper upper middle lower upper upper lower lower upper lower upper upper lower upper upper lower lower middle middle upper middle middle class
dickcharles: lower upper upper middle lower middle middle middle middle lower middle upper upper upper lower upper lower lower upper lower middle lower lower middle lower middle middle class
stanbea: lower lower lower upper middle lower middle lower middle upper upper lower upper upper lower lower upper upper upper middle upper class
marianpati: upper upper upper middle upper lower upper middle upper middle upper middle lower lower upper lower middle lower lower lower middle upper lower middle lower lower class
garytommy: middle middle lower upper middle middle lower upper upper middle upper class
williamviolet: upper lower lower middle middle middle lower lower upper lower upper upper middle lower class
xavierrichard: lower lower lower upper middle lower lower upper upper middle middle middle upper middle class
billpeter: middle upper middle lower middle upper lower upper middle lower lower lower lower lower upper lower upper upper lower upper middle lower upper middle upper middle class
richgary: lower middle lower lower lower middle middle middle lower lower middle middle upper upper lower middle middle upper lower upper middle upper middle middle lower class
suepeter: upper lower middle middle lower lower lower upper lower lower upper middle middle lower upper upper middle class
garyrichard: middle lower upper upper upper upper middle lower upper upper middle lower lower lower upper lower middle lower upper class
hansmark: middle upper upper middle middle upper lower middle lower upper upper upper middle lower upper middle middle upper upper middle upper class
bobpeter: middle upper upper lower lower lower lower middle middle middle middle middle upper upper lower upper middle lower upper middle middle lower lower upper upper class
marianbea: lower upper middle middle middle upper middle upper lower upper upper middle middle upper upper middle upper upper lower upper lower middle upper middle upper lower middle class
stanleyfranz: upper upper upper lower upper middle lower middle middle middle upper upper middle middle middle lower upper upper middle middle middle middle middle middle lower upper class
stanmona: middle lower lower upper upper upper upper middle lower lower upper lower middle lower lower lower lower lower upper class
frankkarl: upper lower upper middle middle middle upper middle middle upper upper lower lower middle lower lower middle lower middle upper lower lower upper upper middle lower middle class
peterstanley: middle middle lower lower lower lower lower middle lower upper upper lower middle lower lower lower middle lower class
wendyed: upper middle lower upper lower middle lower middle middle lower middle lower lower middle middle middle upper middle middle class
peterpeter: upper lower lower middle lower lower middle lower class
billxavier: lower middle upper lower lower lower lower upper middle upper upper middle middle middle upper upper lower middle upper class
luanned: middle middle upper upper middle middle middle middle lower lower middle upper lower class
monicajose: lower lower upper lower middle middle upper middle upper upper lower lower middle class
marymary: middle upper upper lower middle lower lower upper middle lower upper middle upper middle upper upper lower upper lower upper upper upper class
johndick: middle upper lower lower lower middle upper middle lower upper class
stanrick: middle middle upper upper upper middle upper middle lower upper upper upper lower lower class
johnbea: lower lower upper lower upper upper upper upper lower middle upper upper upper middle upper upper upper upper lower lower upper upper middle class
marystanley: middle lower class
frankmona: middle upper upper lower upper middle middle lower upper lower lower upper middle middle lower middle lower lower middle upper middle upper upper lower lower upper class
rickbea: lower middle middle middle middle upper upper lower upper upper lower middle lower upper lower middle middle upper class
peterbob: middle upper middle middle middle lower lower middle middle middle lower middle lower lower middle lower upper upper class
billwendy: upper lower lower middle middle lower middle lower upper lower middle upper middle middle middle lower middle class
hanspati: lower middle lower middle middle lower middle upper upper lower lower middle lower lower lower class
davidluann: lower class
billmarian: middle middle class
patiwilliam: upper upper middle upper lower lower middle middle middle middle lower lower upper upper middle middle middle class
danasue: lower class
stangary: upper lower upper middle lower upper class
garyrich: lower upper middle middle upper middle lower lower middle lower upper upper upper upper upper upper middle middle upper lower lower upper upper lower upper lower upper class
peterarnold: upper middle lower middle lower upper lower upper lower upper middle lower lower lower upper middle middle upper middle middle middle middle middle middle middle class
deannatom: upper middle lower upper lower lower upper lower class
tommyarnold: upper middle lower lower upper upper middle middle upper upper class
danacarl: upper middle lower upper lower class
deannafranz: upper lower lower upper lower lower middle upper upper middle middle middle lower class
johnfranz: upper middle middle upper middle middle middle lower middle upper lower upper middle class
tombill: lower lower lower upper upper class
violetpatricia: lower upper lower middle middle upper lower lower upper upper lower middle middle upper upper middle lower middle middle class
davidpati: middle middle middle upper middle upper upper lower upper upper middle lower upper middle class
monicastanley: lower class
patidavid: middle upper lower upper middle lower upper upper lower upper upper upper upper lower lower middle upper upper upper upper lower class
richardbea: upper lower middle middle lower middle upper lower middle upper lower middle lower middle class
patriciaviolet: middle upper middle middle upper middle middle lower class
richkarl: upper lower middle middle lower upper class
billpati: lower upper upper middle upper upper lower lower upper lower middle upper upper middle middle upper upper upper upper upper upper upper class
carlarich: lower middle lower lower upper lower upper upper upper class
danabob: upper lower class
josedick: middle middle upper class
billpatricia: upper upper lower middle middle lower middle lower middle middle lower middle middle middle upper lower middle upper lower upper middle lower middle upper class
suejohn: lower upper upper middle lower middle upper upper middle middle middle lower lower middle upper middle upper upper middle upper lower lower upper upper upper lower class
rickrichard: lower class
markarnold: middle class
stanjohn: upper upper lower class
richardmarian: lower upper lower upper middle lower middle upper lower lower upper upper middle class
danamonica: lower middle upper upper upper lower lower upper lower lower middle middle middle class
markmarian: upper lower lower lower middle lower middle middle upper middle lower upper lower lower middle lower class
stanleykarl: upper middle class
monastan: lower lower lower lower middle middle lower middle middle middle upper middle lower upper lower upper lower lower upper lower middle middle lower middle class
jackrichard: middle middle middle lower middle upper middle upper upper lower middle middle class
deannafrank: lower class
garymary: upper lower middle lower middle middle lower class
deannabea: upper middle middle lower middle upper middle middle middle upper lower class
arnoldjohn: middle upper upper upper middle upper upper upper middle middle middle upper middle upper upper lower upper upper middle class
charlesgary: lower lower upper lower upper upper middle middle lower upper upper middle upper lower upper upper upper lower lower middle middle middle upper middle upper class
carldavid: middle middle upper upper lower middle lower upper lower lower middle upper upper middle middle middle middle upper class
rickanne: middle middle lower middle lower middle upper middle upper lower middle class
garypatricia: upper upper middle upper lower upper upper upper middle lower upper lower middle lower class
petertommy: middle lower lower middle middle lower upper upper upper lower upper upper upper lower lower middle lower middle upper class
josecarla: middle upper lower lower upper lower upper middle upper upper lower middle lower upper middle upper upper middle upper middle middle middle lower lower class
bobrich: lower middle middle middle lower upper middle upper class
harrysue: lower lower middle lower middle middle middle upper lower upper middle lower upper upper upper upper upper upper middle middle lower upper upper class
annedick: middle middle lower lower lower middle middle upper lower lower upper middle upper upper lower middle upper upper upper lower upper lower lower middle upper class
richardbob: middle upper middle middle lower middle lower lower upper middle lower lower middle middle middle upper lower class
annemary: middle middle upper lower middle lower upper lower lower lower lower lower lower middle middle upper upper upper lower upper lower upper class
danarichard: lower middle lower lower middle lower upper upper middle lower upper upper upper upper middle lower upper middle upper middle lower middle class
davidbob: upper lower lower upper upper upper lower upper middle lower middle upper middle middle class
williammonica: upper middle middle middle lower middle upper upper upper middle upper upper middle upper upper class
rickhans: middle middle upper upper lower lower upper lower middle lower upper middle upper lower lower middle lower class
tommyanne: lower middle class
marytommy: lower middle lower lower upper lower upper upper upper upper middle middle lower lower lower upper lower class
danamark: lower upper middle lower middle lower class
jeffbea: lower middle middle lower lower class
hansmary: upper upper middle middle middle lower middle middle lower lower upper lower upper upper middle lower lower class
davidstanley: middle lower middle upper middle class
jackmark: lower lower lower middle upper middle lower lower lower class
annejeff: upper upper middle middle upper class
danajose: lower lower middle upper lower upper lower lower upper lower upper lower upper lower middle lower middle middle upper lower upper class
franzmona: upper lower upper lower lower lower middle class
johnharry: upper middle upper lower upper class
luannmona: upper upper upper upper lower upper middle upper lower middle middle middle middle middle upper middle upper lower upper class
franzjose: middle middle lower middle lower upper upper lower middle lower middle lower upper class
bobdana: middle middle middle middle lower lower lower lower lower upper upper middle middle middle middle middle lower lower lower middle class
carlaarnold: upper lower upper lower lower lower upper upper upper middle lower middle lower middle middle upper lower lower middle upper middle upper lower upper lower middle class
harryjohn: middle upper upper class
patimark: middle upper lower middle middle middle class
deannaarnold: middle lower upper middle class
annejack: upper lower middle upper lower upper lower lower class
tomfrank: middle lower upper lower lower upper lower middle middle class
patriciapatricia: middle middle middle upper lower upper upper lower upper upper lower middle upper class
davidrichard: middle upper lower middle lower middle middle middle upper upper class
williambill: lower upper upper class
arnoldxavier: middle middle middle lower lower lower lower middle lower middle upper lower upper lower upper lower middle class
arnoldcharles: middle lower upper lower middle middle upper upper upper upper middle middle upper lower middle upper lower upper lower middle middle class
tomharry: middle class
rickstanley: lower upper middle lower middle upper middle middle middle class
maryrichard: upper middle lower upper class
harrypatricia: lower lower middle middle upper lower middle middle upper lower upper class
xavierarnold: middle lower upper lower lower middle middle upper lower lower upper upper upper class
carljack: lower lower middle middle lower upper middle upper upper middle middle upper class
stanleyanne: upper middle upper lower middle middle upper upper upper lower lower lower lower middle lower lower class
carlmarian: middle upper upper upper middle upper lower middle middle middle class
charlesdana: lower middle middle lower class
garyxavier: lower class
garypeter: middle lower middle lower middle middle upper middle lower lower upper upper class
carlajeff: middle lower middle middle class
richmona: middle upper upper upper middle upper upper middle middle upper lower middle lower upper lower upper lower lower upper upper lower upper middle lower lower upper class
bobgary: middle middle upper middle lower middle lower middle upper lower upper upper middle lower upper upper middle middle upper class
charlesdavid: lower upper upper lower middle middle upper upper lower middle middle middle upper upper upper lower upper middle lower upper lower lower lower middle upper lower lower class
peterwilliam: middle upper middle middle lower middle middle upper upper middle middle upper lower middle middle class
danadeanna: upper middle upper middle middle lower upper middle lower middle middle middle upper middle lower lower lower upper class
arnoldrick: middle upper middle middle upper lower upper middle lower lower lower lower lower upper upper upper middle upper lower upper middle middle lower upper lower class
patriciadick: lower lower lower upper lower lower middle upper lower class
arnoldfrank: upper lower lower lower upper lower lower middle upper lower middle middle upper middle lower lower lower middle class
carlaharry: lower upper middle lower middle upper upper middle upper middle upper middle middle lower middle lower upper lower lower middle middle middle lower class
dickkarl: lower upper middle middle lower middle upper lower lower upper class
monicadavid: lower middle lower upper middle lower lower upper middle upper lower upper lower lower lower upper upper upper upper upper class
wendyrichard: lower upper middle middle lower middle middle lower upper lower upper lower middle lower lower middle lower middle middle lower class
rickcharles: lower lower middle middle lower lower upper middle middle lower upper upper middle middle lower lower middle lower upper upper middle middle lower middle lower class
karlrichard: middle lower lower lower middle middle upper middle lower upper class
edpeter: middle middle middle middle lower upper middle upper upper lower lower upper upper lower lower middle middle upper upper upper upper lower lower lower upper middle class
richardjeff: middle lower lower upper class
rickrich: middle upper middle lower upper lower middle middle upper class
hanstom: middle upper middle lower lower class
stanpatricia: middle upper upper lower class
violetmary: upper upper middle class
violetcarla: middle lower upper upper middle upper class
josetom: upper lower upper upper upper upper upper middle lower lower upper upper upper upper middle middle middle middle middle middle lower class
markwilliam: lower lower lower middle lower middle middle class
tomviolet: upper middle lower upper middle upper middle lower lower lower lower lower middle upper middle lower middle upper upper class
harryrichard: lower upper lower class
arnolded: lower lower lower upper lower upper upper upper lower lower class
carlagary: middle class
beadick: lower middle lower upper lower upper class
suebill: upper middle upper lower lower lower lower middle class
rickdick: upper upper upper class
rickgary: middle upper middle middle upper lower middle lower middle upper middle class
josedavid: upper lower middle upper middle upper upper upper upper lower middle lower middle lower middle class
xaviercarla: upper lower lower middle class
beatom: lower middle upper middle upper upper upper upper upper lower upper middle lower lower lower upper upper lower upper lower lower middle middle upper lower class
arnolddick: lower upper lower lower middle lower middle middle lower middle upper upper upper middle middle lower lower class
karled: middle lower lower middle lower middle middle upper upper middle middle lower middle middle lower middle lower lower middle lower lower middle lower middle class
harryhans: lower lower middle upper lower middle lower lower middle middle middle upper lower upper class
violetbea: upper middle lower lower upper class
danaarnold: middle upper lower middle upper lower upper middle lower class
beacarl: lower lower lower middle lower lower middle middle lower lower middle lower middle middle middle lower middle lower upper middle lower middle lower class
marianrichard: middle upper upper middle upper middle middle upper lower upper lower lower lower class
luannanne: upper lower lower lower middle upper lower upper upper middle upper upper lower lower lower lower middle upper middle upper class
ricktommy: lower upper middle middle upper middle upper upper upper upper lower middle upper middle lower middle middle middle upper middle upper class
mariankarl: middle upper middle lower middle middle lower class
johnmarian: middle middle upper upper upper middle upper lower class
joserich: lower class
tommymonica: lower lower upper middle lower upper middle middle upper upper middle upper upper class
bobmona: lower middle middle middle middle class
karlviolet: lower upper middle lower upper middle middle middle lower class
wendyjose: upper upper middle lower class
karlcarl: middle lower lower lower upper class
patriciarichard: lower lower upper middle upper upper upper middle upper upper lower lower lower lower lower middle lower upper middle middle class
luannjeff: middle lower lower middle upper lower lower middle lower upper middle lower class
harrybea: lower lower upper upper upper middle middle middle upper middle middle upper middle middle lower middle middle upper upper lower middle upper middle middle class
wendydavid: lower lower middle upper middle lower lower upper lower upper middle middle upper upper lower lower middle upper upper upper middle middle middle class
franzarnold: middle lower lower middle upper lower middle middle lower middle upper middle lower upper middle class
monacarla: lower lower upper middle lower middle lower middle lower middle middle middle class
garykarl: upper upper upper middle upper upper upper lower middle middle upper middle upper upper lower upper class
tommypatricia: upper lower middle lower middle lower upper lower middle lower upper upper middle lower lower upper lower middle upper middle middle upper lower class
josemonica: upper lower lower middle lower upper upper class
tomjack: lower upper middle upper upper lower upper middle upper lower upper upper upper lower lower middle upper middle upper middle upper lower middle middle lower class
richardmary: upper middle middle lower middle upper upper middle lower class
dickbill: middle lower class
dickpatricia: middle lower lower class
markmary: middle lower lower middle middle lower middle middle middle lower upper upper lower middle upper lower middle lower middle lower lower upper middle middle class
riched: upper middle upper lower middle upper lower middle middle lower upper middle middle class
xavierwendy: lower lower lower upper middle lower upper middle lower upper lower upper upper upper lower middle class
tomrichard: upper lower class
josepeter: lower middle middle upper upper lower lower upper lower upper lower lower middle middle lower class
beafranz: middle middle lower upper upper lower upper lower upper lower middle lower middle upper middle middle upper upper class
petertom: lower lower upper middle upper lower upper upper lower upper middle upper lower lower lower middle middle upper upper upper upper class
harrymark: lower upper lower middle middle middle lower middle middle class
franzjohn: middle middle middle upper upper upper middle middle lower middle class
tommygary: upper upper middle middle lower upper class
davidcharles: upper class
stanleystanley: middle lower middle upper lower lower middle middle lower middle middle lower lower lower upper lower middle middle class
richardarnold: middle lower middle class
eddana: lower lower upper middle lower middle middle middle middle upper middle lower lower upper middle lower upper upper upper lower lower upper upper lower class
williamcharles: lower upper lower lower middle upper lower upper lower lower middle middle upper lower lower upper upper upper upper upper middle middle middle middle upper upper lower class
davidbill: upper middle upper upper upper upper upper class
danabea: middle middle middle middle upper upper middle middle class
jeffstanley: upper class
suecharles: upper upper lower upper upper middle middle class
richdick: upper lower upper middle middle class
luannfrank: lower lower upper upper upper middle middle lower middle class
billstanley: upper middle lower middle middle middle upper lower upper upper lower class
jackfrank: upper lower middle lower upper upper middle upper middle lower middle upper middle middle upper lower middle lower class
dickharry: upper middle upper upper upper middle upper lower lower middle middle middle upper upper lower upper middle lower upper class
jackdick: upper upper middle upper upper upper middle upper upper upper upper middle class
franzrich: lower upper upper upper lower lower middle lower lower lower class
xavierstanley: lower lower middle upper upper middle middle upper middle upper middle lower middle lower middle upper middle lower lower middle upper upper middle upper class
charlesrichard: lower upper middle lower upper upper lower lower middle upper upper middle lower class
bobfrank: upper middle lower upper middle lower middle lower middle class
maryjose: middle upper upper upper upper middle lower lower middle middle middle upper upper middle class
carltommy: middle middle lower lower middle upper middle lower upper class
markviolet: middle middle lower upper lower middle upper lower middle lower upper lower lower middle lower middle lower middle middle upper upper class
carldick: upper lower middle upper upper lower middle middle middle lower upper lower lower upper lower middle lower upper lower class
patriciadeanna: upper lower class
beaarnold: lower lower middle middle middle upper lower middle upper middle lower middle lower lower middle middle lower lower lower middle upper upper lower class
williamharry: lower upper lower middle lower upper middle upper lower class
joseviolet: middle middle lower middle middle lower upper lower middle middle lower middle middle class
richardmonica: lower middle lower upper upper class
marianjeff: lower upper middle middle middle upper upper lower lower lower middle upper lower lower upper lower middle lower lower upper middle upper middle lower middle class
rickpatricia: upper middle upper upper upper upper upper middle lower upper lower upper lower lower upper upper upper upper upper lower lower lower class
johnstan: lower upper middle upper middle upper upper middle upper upper middle upper middle middle upper upper lower middle upper middle lower upper upper class
billfranz: middle upper middle upper class
harrywendy: middle lower lower class
xaviertom: middle class
monicapatricia: upper middle middle lower upper lower lower middle lower upper upper lower lower lower middle lower upper middle lower upper lower class
wendygary: upper middle middle upper lower upper lower lower middle middle lower upper lower lower lower class
richstanley: upper lower middle lower middle middle lower lower lower upper lower middle middle middle class
williamstan: upper lower middle middle lower middle middle middle lower upper middle middle middle lower class
garysue: upper upper lower upper middle middle upper lower lower middle upper middle lower middle middle upper class
jackbob: lower middle middle middle middle lower upper middle middle lower upper middle lower middle upper upper upper lower lower middle middle middle middle middle middle class
monicarick: middle upper upper upper upper lower lower upper upper middle middle upper class
marycarla: middle middle upper lower lower middle middle middle middle upper middle middle lower upper upper lower lower middle lower middle class
josehans: middle middle upper lower upper lower middle upper middle upper upper lower middle lower upper upper upper lower upper upper upper class
bobsue: upper middle middle lower upper upper upper middle middle lower lower upper lower lower middle class
patriciabob: upper upper middle upper upper lower middle lower lower upper middle class
tommybob: lower middle middle upper upper upper middle upper lower upper lower upper lower middle lower lower lower lower upper middle upper lower lower middle middle middle lower class
luannwendy: lower upper lower middle upper lower upper middle upper upper lower lower upper middle middle middle middle upper lower upper lower lower middle upper class
bobbill: middle upper upper lower upper lower middle middle lower upper lower lower middle upper middle middle lower upper middle upper class
xavierxavier: upper middle upper lower lower lower lower middle lower upper upper middle class
luannviolet: lower middle middle upper lower upper upper lower upper middle lower lower middle upper upper lower class
jackmonica: upper lower upper middle upper upper upper middle lower upper upper class
marianmary: middle upper lower upper middle lower middle lower lower middle middle middle upper lower middle lower upper middle lower class
carlapatricia: lower upper middle middle middle upper lower upper middle middle upper upper lower upper upper middle upper upper lower lower lower middle lower upper class
tompati: upper middle lower middle middle middle lower lower lower upper lower middle upper lower lower middle middle upper middle class
deannastanley: middle lower lower lower lower upper upper lower middle middle upper class
harrygary: lower class
davidjack: upper middle middle middle upper lower middle middle middle middle lower middle lower lower lower lower middle middle middle middle lower lower lower upper upper class
davidharry: middle upper upper middle middle upper upper lower middle upper middle middle lower upper lower class
franzpatricia: lower lower middle middle class
charlesjeff: upper middle middle lower lower lower lower middle upper middle middle upper middle middle class
hansluann: upper upper lower middle middle middle lower lower upper upper upper middle lower lower middle lower middle lower middle class
stanleydavid: upper upper middle class
johncarla: upper lower upper middle upper middle middle upper middle middle middle middle middle upper class
carljose: upper lower upper lower middle middle upper class
luannluann: lower upper lower upper middle middle lower upper middle upper lower lower lower upper lower upper upper upper upper lower middle lower lower class
wendystanley: middle upper upper upper middle lower lower upper upper middle lower upper lower upper middle middle lower middle middle lower middle middle lower upper middle middle class
dickcarl: upper middle middle upper lower upper upper middle middle upper upper lower upper lower middle lower upper upper middle lower middle upper upper middle lower class
rickrick: upper upper lower upper lower lower middle lower lower upper lower middle upper middle middle middle class
hansrich: lower upper lower upper upper lower middle lower lower middle lower middle middle lower upper upper middle middle class
dickarnold: upper lower lower upper lower middle upper middle lower lower middle middle lower lower middle lower middle upper lower upper upper lower upper lower upper upper middle class
monawendy: lower middle lower lower lower class
monicasue: lower lower middle middle upper upper lower upper middle middle middle lower upper middle middle lower upper lower middle middle middle upper upper class
carlaanne: middle lower upper middle upper lower middle class
luannfranz: lower middle upper upper lower middle lower middle middle class
williampatricia: middle lower lower upper lower lower middle lower lower middle upper lower middle lower middle upper lower middle upper middle middle lower upper upper upper lower class
richardkarl: lower middle upper lower upper middle middle middle middle upper upper lower upper lower upper upper lower class
garyjeff: middle lower upper middle lower upper upper upper middle lower lower middle upper upper upper upper lower upper upper upper upper upper middle class
franzmonica: lower middle upper lower middle upper upper class
tommyhans: upper middle lower class
frankanne: lower middle upper lower upper middle middle middle upper middle lower middle lower lower lower lower middle class
carlacharles: upper lower lower upper upper lower lower middle class
stanfranz: middle middle lower lower middle class
billviolet: middle upper middle upper middle middle middle upper middle middle middle lower upper lower middle lower lower middle upper middle upper middle class
karljeff: lower middle middle lower upper lower lower middle class
violetsue: upper upper upper upper middle middle lower upper middle lower upper middle upper lower middle class
richardfranz: upper middle lower upper lower upper lower middle lower lower middle lower class
beatommy: lower middle middle upper lower middle class
tompatricia: middle middle upper lower middle upper upper upper lower upper middle upper lower upper middle lower lower upper lower upper middle class
hansbill: lower lower middle upper middle middle upper upper lower upper upper lower lower upper class
danabill: middle lower upper lower middle upper lower middle lower lower upper middle upper middle lower upper middle class
patriciamary: upper lower upper lower middle middle lower middle upper upper middle lower middle upper middle lower middle upper upper class
annedavid: lower middle upper middle upper lower middle lower lower middle upper lower middle middle upper class
richarded: middle upper lower upper middle upper upper lower lower upper upper upper middle lower lower middle upper class
peterharry: upper upper middle lower upper upper lower class
billsue: upper middle lower middle middle lower middle lower lower upper lower class
frankgary: upper lower middle upper middle upper lower upper middle upper upper middle middle middle class
annecharles: upper lower class
williamhans: lower lower lower middle middle upper upper lower middle upper upper lower upper middle middle upper upper upper upper lower middle middle lower middle upper upper lower class
luannpeter: lower middle lower middle middle upper upper upper class
garyjack: middle lower middle upper middle lower lower upper middle lower upper upper middle middle upper lower middle middle middle middle lower lower lower class
charlesmark: upper lower middle lower middle upper upper lower upper lower upper middle upper lower lower lower lower upper lower lower upper upper upper upper upper upper lower class
marianfranz: lower upper middle lower middle lower middle middle upper middle upper upper upper lower lower middle middle lower middle lower lower middle upper upper class
danajack: middle middle upper lower lower lower upper class
edxavier: upper middle lower middle middle middle middle middle upper upper class
tomsue: middle lower upper lower upper lower upper lower lower middle middle upper upper lower upper upper upper upper middle middle lower middle middle middle upper class
billjeff: lower lower upper middle lower middle middle lower upper middle upper lower middle lower lower middle middle middle middle lower upper middle class
patistanley: lower middle lower lower upper lower middle upper lower lower middle middle upper middle middle middle middle lower lower lower middle upper upper class
charleswilliam: middle middle lower middle middle lower middle upper lower upper upper lower upper upper lower middle upper class
marianluann: upper lower middle middle lower class
rickcarla: lower lower lower middle upper upper lower lower upper middle lower middle lower upper lower class
davidrick: middle lower upper lower lower upper lower upper middle upper middle middle class
carlxavier: upper lower lower middle middle upper middle middle lower lower middle middle lower lower lower upper middle upper upper upper upper lower lower lower lower class
carlaluann: upper upper middle middle lower middle middle middle middle lower lower lower class
billluann: middle lower middle lower lower lower middle middle lower upper upper lower lower middle lower middle upper upper class
annebill: middle lower upper lower middle upper upper upper lower lower middle lower middle middle lower middle middle middle upper upper middle lower lower class
jeffcharles: upper upper lower class
tomcarl: middle upper middle upper upper lower upper upper upper upper upper middle upper lower middle upper lower middle upper upper lower middle lower class
violettommy: lower lower middle lower middle upper lower lower lower lower middle lower upper lower class
carladavid: middle middle lower lower lower upper lower middle upper lower middle middle upper upper upper upper upper lower middle class
danapati: lower middle upper middle middle upper upper upper upper middle middle middle upper upper middle lower middle upper lower lower class
josewilliam: lower middle middle lower lower class
josemary: upper upper middle class
marywilliam: upper middle middle lower lower lower middle upper upper upper lower upper upper upper lower lower lower middle lower middle middle upper upper class
jackpeter: upper middle upper middle middle middle upper upper class
dickgary: lower middle lower upper upper middle lower lower lower middle middle middle lower middle lower middle lower middle upper class
violetluann: middle lower middle middle upper upper middle upper middle class
wendyfrank: middle upper middle middle middle lower upper middle lower middle upper upper middle middle middle lower upper class
markbill: upper middle lower lower middle lower lower lower upper middle middle lower lower lower lower middle lower lower upper lower lower upper class
tommyxavier: upper upper class
frankfrank: upper upper middle middle lower middle middle middle middle middle lower class
billarnold: upper upper lower lower middle lower middle lower middle lower class
arnoldpatricia: lower lower middle middle lower upper middle upper middle middle lower lower middle upper middle middle upper lower middle middle middle class
garyfrank: lower upper middle upper lower upper upper middle lower upper middle class
hansharry: upper middle middle middle upper middle class
monaxavier: lower upper upper middle lower middle lower upper middle upper middle upper middle upper upper lower upper middle upper upper class
dickstanley: lower middle middle lower upper middle upper upper middle upper upper upper lower upper upper lower lower upper upper middle class
deannajose: lower middle lower lower middle upper class
eddeanna: middle lower upper middle middle upper lower upper upper upper lower lower middle upper lower middle upper class
maryxavier: lower lower upper middle middle middle middle lower middle middle lower upper lower lower lower middle middle upper upper upper lower lower middle lower upper upper middle class
hanssue: middle upper lower middle lower middle lower upper lower upper middle lower middle upper upper lower middle upper lower lower upper class
frankbill: middle middle middle upper upper middle middle middle middle middle middle lower lower upper lower middle middle upper middle lower upper upper class
bobtommy: upper middle middle lower class
patirick: lower middle lower lower middle middle upper class
suerich: middle upper upper middle upper middle lower upper upper middle lower upper lower upper lower upper lower lower lower upper middle upper upper lower upper middle class
marytom: upper lower lower middle middle middle lower lower lower lower upper middle middle upper lower class
carlwilliam: middle lower upper upper upper lower upper lower lower upper middle lower lower lower upper class
suepatricia: middle middle upper middle middle middle middle lower middle lower upper lower upper lower lower middle upper class
deannawendy: middle lower lower class
monadick: middle middle lower upper upper lower upper middle class
karlstan: upper class
luanndana: upper upper lower lower middle middle lower upper middle upper lower middle lower middle upper upper lower lower upper upper class
harryed: lower lower upper lower upper upper middle middle middle upper lower middle lower upper lower lower middle lower middle lower class
carlpati: lower middle middle upper middle upper lower lower upper middle upper upper upper class
patriciaxavier: lower lower lower lower middle lower middle middle middle lower upper upper upper lower lower upper lower upper middle middle class
richjack: middle middle middle lower middle lower middle lower lower upper upper lower upper lower upper middle middle middle upper middle lower class
marypeter: upper lower upper middle upper middle lower upper middle middle upper middle upper lower upper middle upper upper upper upper lower lower upper class
frankrick: upper upper class
karlmonica: middle upper lower lower upper upper middle upper lower upper lower middle lower middle lower upper middle lower upper lower upper middle upper upper middle lower class
richardpatricia: lower middle upper upper lower lower lower middle middle upper upper lower lower upper upper middle middle upper upper middle class
wendyanne: upper upper class
marktommy: upper upper lower middle class
harrytom: upper lower middle upper upper upper middle lower lower class
peterdeanna: lower upper middle middle middle middle middle middle middle middle lower upper lower middle upper lower upper lower lower middle class
johnbob: upper upper middle middle middle middle upper middle lower middle upper middle upper middle middle middle upper middle lower middle upper middle lower upper lower lower class
rickstan: middle lower middle lower lower upper middle lower lower lower upper class
hanstommy: middle upper middle middle upper middle lower middle lower middle middle upper lower upper upper upper lower lower lower upper class
franzanne: lower middle middle lower lower class
beadavid: lower lower middle lower upper middle lower middle middle lower upper upper lower upper middle middle class
wendyrick: lower upper lower lower lower upper middle lower upper middle upper upper lower upper lower lower middle middle lower middle upper middle class
harrypati: lower middle middle lower lower middle middle upper lower upper lower upper middle upper lower middle middle class
tommystan: lower lower lower middle upper upper lower middle lower middle upper middle upper class
tomarnold: lower upper upper lower upper class
charleswendy: lower middle lower upper middle lower middle lower lower upper upper upper upper upper lower middle upper lower upper upper upper upper class
jeffmary: upper upper lower middle middle upper class
violetharry: upper middle upper upper middle lower class
karlkarl: upper middle lower upper upper lower middle middle middle lower lower middle lower middle upper upper upper lower class
suerick: lower upper upper upper upper upper lower middle lower middle middle upper middle upper upper upper class
richstan: upper middle middle lower upper lower upper middle upper middle middle middle middle middle upper upper middle middle lower upper lower middle middle lower lower lower upper class
arnoldkarl: upper upper middle upper middle upper middle middle middle class
patibob: middle middle upper lower upper middle upper upper upper upper lower lower middle lower middle lower lower upper upper middle lower middle middle upper upper class
karldana: middle middle upper upper lower upper upper middle lower class
markdana: lower middle lower upper middle lower middle middle lower middle lower lower middle lower middle lower upper upper lower lower lower upper class
jacktom: middle middle upper middle middle lower class
johnwendy: middle middle lower upper upper lower upper upper upper upper class
stancarla: middle lower lower middle upper lower upper middle upper upper middle lower upper upper upper class
franzhans: lower lower middle lower lower middle middle upper lower middle upper upper lower middle upper middle middle upper lower lower middle class
monicamona: upper upper middle lower middle class
carlcarla: upper lower lower lower middle lower upper upper lower upper upper middle middle middle upper upper middle class
xavierwilliam: upper upper upper lower middle upper middle upper lower middle lower upper middle upper middle upper class
johnmary: upper middle middle lower middle lower upper lower lower upper middle upper middle lower upper lower lower lower upper lower middle upper middle lower lower upper middle class
johnviolet: middle middle class
harryfrank: upper upper middle middle middle upper upper middle lower middle lower middle middle upper upper upper upper middle lower upper lower lower class
danawendy: middle upper lower middle middle upper middle lower middle lower class
patriciajeff: upper upper upper lower lower upper lower lower middle upper middle upper upper class
monajack: middle lower upper lower upper upper lower middle upper class
jeffluann: upper lower lower middle lower middle upper class
monamonica: lower middle lower middle middle class
marianmona: upper middle middle lower upper middle middle middle lower lower upper upper lower middle lower upper lower middle upper middle class
billrichard: lower middle upper lower upper lower upper middle middle lower middle lower lower upper upper middle upper upper middle middle middle lower middle lower upper upper class
richardcarla: middle middle lower lower upper middle lower lower lower upper upper upper lower class
markcarl: lower middle upper middle upper lower middle upper upper middle middle upper upper lower upper middle middle middle upper middle upper middle lower class
luannrick: middle lower upper upper lower upper upper lower lower upper upper upper lower upper upper class
tomdavid: middle middle upper lower lower lower class
beaviolet: middle upper middle lower middle lower lower lower upper lower middle middle lower lower upper upper lower middle lower middle upper upper upper middle upper class
luannmonica: lower lower middle upper lower upper upper upper upper lower middle upper middle upper middle upper upper upper lower lower upper upper middle middle class
hansjack: lower middle middle upper middle upper middle lower class
tommywilliam: middle class
karlstanley: middle upper middle lower lower middle class
dicked: middle lower upper upper middle upper upper lower middle upper middle lower middle lower lower upper middle upper middle class
garyed: upper lower middle lower upper lower upper upper upper lower middle lower class
richanne: middle middle middle upper lower upper lower upper upper middle lower upper lower middle upper middle upper upper upper lower upper middle class
edcarl: middle middle lower upper middle lower class
hansmarian: lower upper middle lower middle lower middle middle upper middle upper upper lower lower upper middle middle lower middle class
tommypeter: upper middle lower upper lower middle middle middle lower upper middle upper middle middle lower upper upper middle middle middle middle middle middle lower lower class
josemona: middle upper middle middle middle lower upper lower lower upper upper middle middle middle class
harrydeanna: upper upper lower middle lower lower lower lower middle lower lower middle upper middle lower upper lower upper upper middle lower class
maryviolet: lower lower middle upper middle class
beahans: upper upper upper upper middle lower upper lower upper lower upper upper upper middle lower lower middle class
deannacarla: lower middle upper upper upper upper lower lower middle lower class
richjose: middle middle upper middle upper middle lower lower upper middle middle middle middle middle upper middle middle lower lower upper lower lower upper upper upper lower upper class
stanleyrick: lower lower lower middle middle upper lower lower middle lower middle lower upper lower upper class
suedick: middle upper lower upper lower upper class
danadavid: lower lower middle lower lower lower middle lower lower upper middle class
richarddana: middle upper class
jeffpatricia: lower lower upper lower upper lower upper class
wendymary: lower lower middle middle lower upper middle class
wendybob: upper upper lower upper lower middle upper upper lower upper upper upper middle upper upper lower class
annexavier: upper lower upper middle class
arnoldarnold: lower lower upper lower lower lower upper middle upper lower middle middle lower lower class
jackcarl: upper lower upper lower lower middle middle middle upper upper upper upper middle middle lower upper upper class
monicaviolet: upper middle lower lower upper lower middle class
josesue: lower upper middle lower class
williamjohn: upper middle lower lower upper lower middle upper upper middle upper upper class
billfrank: middle middle middle upper middle upper lower lower middle upper upper middle upper lower middle upper lower lower lower class
daviddick: upper middle middle middle upper upper middle lower lower lower lower upper lower upper lower class
carlpeter: lower lower lower lower middle upper middle upper lower upper upper lower middle upper upper lower middle lower upper middle upper middle lower upper class
arnoldpati: upper lower middle upper lower upper middle middle class
franzwendy: upper upper lower lower upper lower lower upper upper middle upper lower upper lower upper lower lower middle lower lower lower middle upper upper class
stanwilliam: upper middle middle lower lower lower upper upper middle middle middle upper lower upper upper upper middle upper upper lower class
jackluann: lower middle lower lower upper lower middle lower middle lower middle middle upper middle middle middle middle upper upper lower middle class
annegary: upper middle lower lower class
hansstanley: lower class
annestanley: lower upper lower upper upper lower upper middle middle lower upper middle upper middle upper lower upper middle middle middle class
monacarl: middle upper class
deannaluann: middle middle upper middle upper lower middle upper upper upper lower lower upper lower middle middle lower upper upper class
danastanley: upper upper lower lower lower lower middle middle lower lower middle lower upper lower upper lower middle upper upper middle upper lower middle class
johndeanna: lower middle middle middle upper middle upper middle lower upper lower middle middle upper upper middle lower upper upper upper lower class
carlatommy: upper lower middle lower lower upper lower lower middle middle upper middle lower lower upper middle middle lower class
jefffranz: middle upper upper lower middle middle upper lower upper upper upper lower lower lower middle lower lower lower middle upper middle upper upper upper upper class
davidxavier: middle middle upper middle middle lower lower middle upper upper upper middle middle lower lower lower lower lower middle middle class
eded: upper upper lower upper middle lower middle middle upper middle lower middle upper middle lower upper lower middle lower lower upper upper class
patidick: lower upper upper lower upper upper middle lower lower lower lower upper upper lower middle upper lower lower lower upper lower lower upper class
jackdana: lower lower middle class
deannabill: middle upper lower upper lower middle upper middle upper middle lower middle upper upper class
jeffbill: lower middle upper lower middle middle lower lower middle middle lower middle middle lower upper lower middle lower upper upper upper middle middle upper upper lower class
peterwendy: middle lower upper middle middle lower middle middle upper middle middle lower middle upper middle class
tomstan: upper upper middle middle lower lower lower upper lower lower middle lower upper upper middle middle upper upper upper lower upper lower upper lower middle middle middle class
marydeanna: lower middle upper lower middle lower middle upper middle class
karlfrank: lower upper lower upper upper upper upper middle upper upper lower middle upper upper upper upper middle upper lower middle upper middle upper upper class
richardstan: upper upper upper upper upper middle middle upper middle upper upper class
maryharry: upper upper middle lower lower middle upper upper lower lower middle upper lower lower middle middle middle lower upper lower middle middle lower class
richtommy: upper upper middle middle upper lower upper upper lower upper upper middle class
danarich: lower upper upper middle middle middle class
tommyjack: lower middle upper middle middle upper lower middle lower lower middle lower upper class
anneluann: middle lower upper middle upper lower lower lower lower lower middle lower lower class
carlahans: upper upper middle upper upper middle upper middle lower lower lower upper class
beasue: upper middle upper middle upper class
franzcarl: upper upper upper upper middle middle upper middle lower lower lower middle middle upper upper middle lower upper lower upper upper class
violeted: middle class
beacharles: middle upper middle lower upper lower middle lower middle lower class
richbea: upper upper middle upper middle lower middle class
stanbill: upper upper upper lower lower upper upper upper upper middle class
carldeanna: lower upper upper class
edjose: upper upper middle middle upper lower middle lower upper lower middle middle lower lower lower middle upper middle lower lower class
hanswendy: lower lower upper middle upper middle middle upper middle middle middle lower lower lower upper lower lower middle class
patimona: middle upper upper lower upper middle lower middle lower upper lower middle lower middle lower lower middle middle middle class
markpeter: upper upper middle class
annecarla: lower class
frankdavid: middle lower middle middle upper upper middle upper upper lower lower lower class
rickwilliam: middle middle middle lower lower upper upper upper lower middle lower upper upper lower upper lower middle middle upper lower middle lower middle upper class
suerichard: upper upper lower lower upper lower class
jeffrick: upper class
karlrich: lower upper middle lower lower upper upper middle upper lower upper class
standavid: middle middle upper middle upper lower upper lower lower middle upper lower upper middle upper lower upper lower lower lower upper upper lower upper middle middle class
carlacarl: middle class
luannrich: upper lower upper lower lower lower middle upper lower lower middle lower upper middle lower upper upper lower middle middle middle lower lower middle class
peterfrank: middle upper middle upper lower upper middle lower middle upper upper upper middle lower upper upper upper lower middle class
frankpeter: lower lower middle lower upper upper upper lower upper lower upper lower upper middle middle class
maryed: lower upper middle lower middle lower lower upper upper middle lower middle lower lower upper lower class
stanleyarnold: upper upper lower middle lower middle middle middle upper lower lower lower middle upper lower middle lower class
frankarnold: lower lower middle middle lower class
johnjose: upper lower lower lower lower upper lower class
williambob: lower upper upper upper upper upper upper lower lower middle middle upper middle middle upper middle upper lower middle middle middle upper middle upper middle upper middle class
richwilliam: upper lower upper middle upper lower upper middle upper middle class
richarddavid: upper lower lower upper lower lower lower upper lower lower middle lower lower lower upper upper middle middle lower middle middle lower upper upper upper middle middle class
marygary: lower upper lower lower lower upper lower upper middle lower upper class
jackdeanna: upper lower middle lower upper upper lower upper middle middle lower upper lower middle middle lower middle lower upper lower middle lower upper class
karlpatricia: lower lower upper upper lower lower middle lower upper upper middle class
monicakarl: lower lower upper upper upper upper middle middle lower lower middle middle middle upper lower middle lower class
garybob: middle middle middle class
annerich: upper lower lower middle upper lower lower class
suepati: lower lower upper upper lower upper middle lower middle lower middle lower class
