1000
jeffharry: upper upper upper middle lower lower lower lower middle lower lower upper upper lower upper middle upper middle lower middle class
deannaarnold: upper lower upper upper lower middle lower middle upper class
dicktommy: lower middle middle middle middle middle lower upper middle lower lower middle lower lower middle class
tompati: upper lower lower lower middle lower lower upper upper middle middle upper lower upper lower middle upper upper lower lower class
annebill: middle lower upper middle middle lower middle upper upper lower upper lower lower lower upper class
rickarnold: upper middle upper upper middle upper upper middle lower upper upper lower lower upper upper upper middle lower class
monakarl: lower upper upper lower upper lower lower lower middle class
xaviergary: lower upper middle upper class
peterdeanna: upper lower upper lower upper upper middle upper upper lower lower middle middle middle upper upper middle upper lower middle upper class
josexavier: middle lower lower middle lower middle middle middle lower lower middle lower lower middle lower middle upper middle lower middle middle lower upper upper upper middle class
jackdavid: upper upper middle middle class
luannviolet: lower upper upper upper class
jackcharles: upper class
dickmonica: lower lower lower middle upper middle lower middle middle upper lower upper upper lower middle lower upper upper upper upper upper middle lower upper upper class
carljohn: upper upper middle upper lower middle upper lower middle middle lower middle lower class
tommona: middle middle upper lower upper lower upper upper lower upper middle upper middle lower middle upper middle middle middle upper lower middle lower upper lower middle upper class
beamonica: lower upper middle upper lower lower lower middle lower lower class
edbob: lower lower lower lower middle class
jackwilliam: middle middle upper upper upper upper lower middle middle class
luannpati: upper upper lower lower upper lower upper upper lower lower upper middle middle lower upper middle class
dickviolet: lower middle middle class
karlrichard: upper middle upper middle middle middle middle class
monicahans: lower lower middle middle upper upper upper upper lower middle middle lower upper lower upper upper upper lower lower class
monicabill: lower middle middle middle middle upper lower upper upper lower lower upper upper middle class
dickcarla: upper lower middle upper lower class
patidavid: middle middle lower middle upper lower lower lower upper middle middle upper upper middle lower class
beamark: upper middle upper lower middle upper upper middle class
marianrichard: lower middle lower middle upper middle upper middle upper lower lower upper upper middle middle lower lower middle middle lower middle class
franzmark: upper middle middle upper middle lower upper middle lower middle upper middle upper class
beakarl: middle lower middle lower middle class
johnmona: lower upper lower lower lower lower upper lower lower middle middle lower upper middle middle middle middle upper lower lower class
karlbob: lower middle lower middle upper middle lower upper upper lower upper upper middle upper upper lower lower middle middle lower lower upper upper class
stanjeff: upper lower middle middle upper upper upper lower upper upper upper middle upper lower class
suedick: lower middle middle upper upper lower lower upper upper class
suehans: upper lower lower lower upper lower upper middle lower upper upper lower middle middle lower middle middle class
violetbill: lower middle lower lower middle lower middle lower lower lower middle lower upper lower upper lower upper upper lower middle lower middle class
josemarian: upper upper upper upper lower middle lower lower lower lower middle lower lower upper class
tommonica: upper lower lower middle lower upper upper upper upper lower lower upper lower lower lower upper upper middle upper lower middle class
marianpeter: upper lower class
tommycarl: upper lower middle upper upper lower upper lower lower upper lower lower upper middle upper upper middle upper upper middle upper lower lower lower upper class
franzfranz: upper middle upper middle middle lower upper upper lower upper lower middle middle lower upper middle lower upper lower lower upper middle class
violetcharles: middle upper lower lower middle upper upper upper middle middle upper lower upper upper middle lower middle lower upper class
charlesgary: middle lower middle lower upper upper middle upper middle lower upper middle upper lower middle upper class
petercharles: middle middle lower upper middle lower lower lower upper lower middle middle lower lower lower lower middle lower upper class
wendystanley: upper lower lower class
arnoldrich: middle lower middle lower upper upper lower upper upper upper upper upper lower lower lower middle middle upper middle lower middle class
monaviolet: upper middle lower class
josebea: lower upper upper upper upper upper middle middle lower upper middle middle upper middle upper upper upper class
bobtommy: lower middle lower middle upper lower upper lower middle lower middle class
tomgary: upper lower middle middle upper upper upper lower middle lower middle lower upper lower upper middle upper lower middle lower upper upper middle middle lower lower lower class
tommycarla: middle upper lower middle middle upper lower class
carlbob: middle upper lower lower middle upper upper lower upper middle middle lower middle middle upper lower upper lower upper middle upper middle middle lower middle class
tommyviolet: middle lower middle middle lower middle lower upper class
carlabea: upper lower middle lower upper lower upper upper lower lower lower upper upper middle middle class
richkarl: lower upper lower middle upper middle middle lower lower upper middle middle lower upper lower middle middle lower class
harrymark: lower middle upper middle middle middle middle upper upper lower lower upper class
dicksue: lower middle upper class
monaharry: upper lower lower middle lower lower middle lower upper lower upper middle upper lower upper lower upper middle lower class
charlesjohn: upper lower middle middle lower middle middle upper lower lower class
markmonica: upper upper lower lower lower lower middle upper upper class
johnanne: lower lower upper lower lower lower upper upper lower upper lower upper lower class
richmarian: middle middle upper lower upper lower lower lower middle lower lower middle lower middle middle upper lower middle upper lower lower upper upper lower upper upper class
arnolddick: lower class
monicadana: lower upper middle lower middle middle lower middle lower middle upper lower middle upper upper lower middle upper lower middle upper middle middle middle middle class
markpati: upper lower middle middle middle middle lower class
josepeter: upper middle middle middle class
richgary: lower middle upper middle class
carltommy: lower lower middle upper upper upper middle lower lower middle lower middle lower lower upper upper lower middle upper middle upper class
charleskarl: upper middle middle lower lower middle upper lower middle lower upper lower upper upper lower lower middle lower middle middle class
charlesmarian: middle lower lower lower class
xavierrick: middle class
patriciapati: upper upper upper class
frankpatricia: upper lower lower middle upper upper lower lower upper upper upper upper middle lower upper upper upper lower middle lower upper lower lower lower middle class
xavierfrank: middle upper upper lower lower upper upper middle upper lower lower lower lower lower lower lower class
annemarian: middle upper middle upper lower middle lower middle middle middle middle class
stanleycarla: middle upper lower upper lower class
monamary: upper lower lower lower middle upper lower lower lower upper upper lower upper upper middle lower upper lower lower lower middle lower class
tomrich: upper lower upper lower middle upper lower upper lower middle lower lower upper lower lower middle middle upper upper middle middle middle middle lower middle lower lower class
williamluann: upper upper middle middle middle middle middle middle middle upper upper lower middle upper lower class
richardrichard: upper middle upper lower upper middle middle upper middle upper lower upper upper upper middle middle class
garytom: middle middle lower lower lower upper middle lower upper middle middle middle class
monicajohn: upper middle middle upper upper upper lower lower lower middle lower middle middle upper upper middle middle middle lower lower lower upper middle lower middle upper lower class
peterdana: upper upper upper lower upper middle upper middle upper upper middle lower upper lower upper upper middle middle lower lower upper upper class
stanjohn: lower lower upper upper upper middle upper lower upper class
garymona: middle lower lower middle middle lower upper lower lower upper upper lower lower lower upper upper lower class
williamtommy: middle lower middle upper middle upper lower middle upper upper upper lower lower middle lower middle class
garymonica: lower lower upper middle middle middle upper middle class
franzpatricia: lower middle class
richpatricia: middle upper upper middle middle upper lower upper middle lower lower lower upper upper middle middle upper upper lower lower lower middle middle middle class
beacharles: upper lower upper middle middle lower upper lower lower lower class
joseharry: lower lower middle lower upper middle lower upper lower class
annemonica: middle lower upper class
williamstanley: upper middle lower lower middle middle middle middle class
richardcarl: middle upper lower middle middle lower lower upper middle upper lower lower lower lower class
annewendy: middle middle lower middle middle middle upper middle middle middle upper middle middle lower middle middle upper middle class
patifrank: lower upper middle lower lower middle middle lower middle lower middle upper middle upper middle upper upper middle upper upper lower upper upper middle class
davidsue: middle lower lower lower lower upper lower middle middle upper lower lower middle middle lower middle upper lower lower lower lower lower lower upper upper lower middle class
richarddick: lower middle middle middle middle lower lower middle upper middle middle upper upper middle middle lower lower middle class
carldana: upper middle middle middle lower middle middle middle upper upper middle middle middle upper class
wendydavid: middle lower middle upper lower upper lower lower lower upper lower lower class
karlmonica: upper middle lower middle class
stanleyarnold: middle lower upper middle upper middle upper upper middle class
stanleymonica: middle upper middle lower lower upper upper upper lower middle upper middle upper lower lower class
harrycharles: upper lower lower upper middle class
danacarla: upper middle lower lower lower upper lower lower upper upper lower class
patibea: lower lower upper lower upper upper upper middle upper middle upper middle middle upper middle upper upper middle upper middle middle lower lower middle lower middle lower class
stanpatricia: middle lower upper upper class
beadick: middle middle class
deannawendy: lower upper upper middle middle upper lower middle upper upper upper middle upper middle middle upper upper middle class
tommyhans: upper lower upper class
danaluann: middle upper middle lower middle lower upper middle lower upper middle upper lower lower upper middle upper upper middle middle class
violetarnold: middle lower lower upper middle upper lower upper middle middle middle upper lower upper middle upper upper middle upper class
monarich: upper middle class
davidjohn: middle upper middle lower middle class
wendyanne: middle middle lower middle middle upper lower middle middle lower lower upper middle middle middle upper upper lower lower lower class
harrypati: middle middle middle upper lower upper middle upper lower middle upper middle lower upper lower middle lower upper upper upper lower lower upper middle lower lower class
luannarnold: lower middle upper lower lower lower middle middle middle middle lower upper class
richarddavid: upper class
annerichard: upper class
carlarichard: upper upper lower middle middle middle upper upper middle middle middle upper upper middle upper class
edpati: upper lower middle middle lower upper lower lower lower lower middle middle middle middle upper upper class
frankstanley: upper upper class
charlesmonica: lower upper lower lower upper upper middle middle middle middle upper middle middle lower middle middle middle class
bearick: lower upper middle middle middle upper upper lower middle middle lower middle upper upper lower upper upper lower class
franzharry: upper lower middle class
bobpatricia: lower upper lower middle middle middle middle middle upper class
mariancarla: middle upper middle middle upper middle middle lower class
markluann: lower lower lower upper upper middle lower middle middle lower upper lower upper lower lower middle upper class
stanleypeter: middle middle middle upper lower lower upper lower lower middle middle middle lower lower middle upper middle lower middle upper middle lower middle class
karlwendy: lower upper upper upper upper lower middle middle upper upper class
xavierdick: upper upper lower middle upper lower middle lower upper upper middle lower middle upper lower middle lower lower upper middle middle class
danadeanna: middle middle upper middle upper lower upper upper middle upper class
carlabill: upper lower middle upper lower middle middle middle upper class
xaviermarian: lower upper middle middle upper upper middle upper upper upper upper upper upper upper upper middle middle lower upper middle middle middle middle upper lower lower class
richardanne: middle upper lower middle middle upper lower lower upper upper lower upper lower middle middle middle lower lower upper upper lower upper upper lower middle class
billwendy: upper upper upper lower lower middle upper lower lower middle middle lower middle upper lower middle lower upper middle lower middle middle middle upper upper lower class
bobdick: lower lower upper upper upper upper upper lower upper middle lower upper upper upper middle class
arnoldbob: upper class
markmark: lower upper middle class
monatommy: upper middle upper middle lower upper lower upper lower upper upper upper middle middle middle upper class
richardjack: lower lower lower lower upper class
carlastan: middle upper lower lower upper middle middle upper lower middle middle middle middle upper lower lower class
monicapeter: middle upper middle lower upper middle middle middle upper middle middle upper lower upper upper upper middle upper middle middle middle class
stangary: middle middle upper middle upper middle middle upper middle middle class
davidarnold: lower middle middle middle lower lower upper upper lower lower lower lower lower lower lower class
stanxavier: upper middle upper middle class
stanstan: lower upper upper lower middle upper upper lower upper lower upper middle lower lower middle lower middle class
garymary: lower upper middle lower lower middle lower middle middle upper upper middle upper lower middle lower lower upper upper upper upper upper class
johnrich: lower upper upper middle lower middle upper upper lower lower middle lower upper middle class
patriciawendy: upper middle middle middle middle upper upper class
marianhans: lower upper middle upper lower lower upper upper middle middle lower upper upper class
joseviolet: middle lower lower upper middle upper upper upper middle lower upper lower upper lower upper lower lower middle upper lower lower middle upper lower upper lower lower class
danabea: lower lower lower lower upper upper lower lower upper lower middle upper middle upper upper middle upper middle middle middle lower upper middle lower middle class
patipeter: middle lower middle upper lower upper lower middle class
tommyrich: upper lower middle lower middle lower upper upper middle class
frankcharles: lower lower middle middle upper middle upper lower lower lower class
edcarl: lower lower middle middle lower upper lower middle lower class
markanne: upper upper lower upper upper lower middle middle lower middle middle middle middle middle middle middle upper lower upper class
danatom: middle lower lower middle lower upper upper lower class
violetdana: upper middle upper middle middle upper lower lower upper middle lower lower middle upper lower middle middle lower upper lower middle lower middle class
monaed: upper lower upper upper lower lower class
davidpeter: middle lower lower class
edrich: middle upper middle lower upper middle upper upper middle lower lower middle middle upper middle upper upper upper lower lower upper lower lower upper upper middle class
marianmona: upper lower lower middle middle upper upper middle lower class
monabea: lower upper middle middle lower lower upper middle middle lower upper middle middle lower upper middle class
billjeff: middle middle lower lower upper middle lower middle upper middle lower lower upper upper upper lower upper middle lower middle class
carlhans: lower lower lower upper lower lower lower lower upper lower lower middle upper upper upper upper middle upper lower upper lower lower lower middle class
williamdeanna: lower lower upper upper lower middle lower lower upper upper lower upper class
franzed: middle middle middle middle lower middle lower middle lower upper upper middle upper middle middle upper upper middle upper lower middle class
franzjose: middle upper middle lower upper upper upper middle upper upper upper upper upper lower lower lower lower upper upper lower middle upper middle lower upper upper class
karlviolet: upper lower upper middle upper class
stanleyjohn: middle upper lower class
bobed: upper lower lower upper upper upper lower lower class
markwilliam: upper upper middle upper upper middle lower upper lower lower upper middle upper upper middle upper lower lower middle upper upper lower middle lower class
johnviolet: upper upper middle upper middle lower class
edkarl: lower lower upper upper lower middle lower upper upper middle middle middle upper upper lower lower middle lower upper lower middle lower upper middle lower middle upper class
dickcharles: middle upper upper middle lower middle middle lower upper lower middle upper lower middle class
hanskarl: upper lower lower lower upper upper middle lower lower lower upper middle upper middle lower middle lower lower lower lower lower middle middle upper lower upper class
karlbill: lower lower class
arnoldjohn: upper lower lower lower lower lower upper upper lower middle upper lower upper upper middle lower upper upper lower class
stanleyrick: upper upper upper lower middle lower upper lower middle class
williamxavier: upper middle lower middle middle middle lower class
josedana: lower middle upper lower middle middle middle lower upper upper upper upper lower lower middle middle upper upper middle upper middle upper middle lower upper class
suemona: middle middle class
marianpati: lower middle upper upper upper lower upper upper middle upper upper middle upper lower upper middle lower middle upper lower middle class
xavierjack: upper middle middle lower lower class
stanmona: lower middle middle upper middle middle lower lower middle upper lower class
davidmona: middle upper upper lower middle middle upper lower lower middle lower class
carlmark: middle upper middle lower lower middle middle lower upper upper lower middle lower lower upper upper lower upper upper upper middle upper upper class
garybill: upper middle middle upper middle upper class
johnwilliam: lower upper middle upper middle middle middle upper middle lower lower lower middle middle lower upper middle middle lower middle upper middle lower lower lower class
stanmary: upper upper upper middle upper upper upper lower upper upper middle upper lower lower upper lower lower middle upper upper upper lower upper upper class
karlrich: lower middle lower lower class
annepatricia: lower middle lower middle upper middle upper lower upper lower lower lower upper middle class
hanswilliam: lower lower middle upper lower middle upper lower lower lower lower lower upper lower upper upper upper middle lower lower middle lower class
carlagary: upper lower middle upper middle upper class
frankmary: middle lower upper lower middle upper upper upper upper class
stanleyxavier: lower lower upper upper lower middle upper middle lower middle lower lower upper upper upper upper middle lower class
josemary: middle middle upper lower upper lower middle middle middle middle upper lower class
xavierbea: middle upper middle upper upper upper upper upper middle middle middle middle lower upper upper class
billluann: middle class
bobhans: lower lower upper middle upper middle middle upper middle middle upper upper upper upper lower middle upper lower lower middle lower lower upper upper upper lower class
marianharry: upper middle middle upper lower upper middle lower middle middle middle upper class
violetmona: middle middle upper lower middle upper lower lower upper middle lower upper class
deannarich: lower lower middle middle class
charlescarl: lower upper middle middle lower middle upper middle middle middle middle middle upper upper middle upper upper middle middle lower middle lower upper class
wendyfranz: upper lower lower upper middle middle lower lower class
beajose: lower middle lower middle upper lower lower upper middle lower middle middle upper middle lower upper middle middle class
violeted: upper lower middle lower middle lower middle lower lower middle upper middle upper lower upper upper upper lower lower upper lower lower upper upper lower upper upper class
marypatricia: lower middle lower middle middle middle lower middle upper lower upper lower lower upper upper class
billviolet: lower upper lower lower lower upper lower middle class
annejose: middle middle upper middle upper upper lower upper upper lower upper upper upper middle lower middle upper lower middle class
johnbea: middle middle middle lower middle middle lower upper middle middle middle upper middle lower upper middle lower lower upper middle middle middle upper class
deannadeanna: middle lower upper upper middle middle middle middle middle lower class
bobjack: middle middle upper lower lower lower upper middle class
edbill: middle middle class
charlesdana: upper middle middle middle lower middle middle middle upper middle middle lower lower upper upper middle upper upper middle lower class
richjohn: middle lower middle middle middle middle upper middle upper lower middle upper lower lower middle lower upper upper upper upper middle middle middle middle middle class
charlesdick: middle lower upper upper lower lower lower lower upper lower middle lower lower class
carlacarla: upper lower lower upper lower middle upper upper lower middle middle upper class
patriciastan: upper lower middle middle middle upper middle middle middle middle upper lower lower middle lower lower lower middle lower lower middle middle middle lower middle middle middle class
tommark: middle middle lower upper middle upper lower lower middle lower upper upper middle lower middle lower lower upper upper class
richjeff: upper lower upper lower upper lower middle lower upper middle lower lower middle lower lower lower middle middle lower lower lower class
bobbill: lower middle upper upper upper middle lower middle lower upper upper lower lower middle upper upper lower upper middle upper upper middle lower middle upper upper middle class
charlesbea: middle upper middle lower upper middle middle middle middle lower lower middle upper lower lower lower lower middle lower middle upper lower lower middle middle upper class
violethans: middle lower lower upper lower upper upper upper lower middle lower upper middle lower lower middle middle upper lower class
williamdick: middle upper lower lower upper lower upper middle upper upper lower middle upper lower lower lower upper lower upper upper upper class
stanleyrichard: upper middle lower lower upper middle upper lower upper upper middle middle middle lower upper upper middle middle middle upper upper upper lower middle class
stancharles: lower class
davidluann: lower middle upper middle lower middle middle middle lower upper middle upper middle middle upper upper upper lower lower lower middle middle class
johnkarl: middle upper middle lower middle middle lower lower middle upper lower class
patideanna: lower middle upper middle lower lower lower upper middle middle upper middle upper upper lower middle upper upper upper upper upper lower lower class
davidrichard: middle middle middle middle upper middle middle upper upper middle upper middle upper upper upper middle lower lower upper upper lower lower class
violetfranz: upper middle middle class
jacked: lower lower lower lower middle middle lower middle lower upper upper lower upper middle lower middle middle upper lower lower middle lower upper upper class
edmarian: middle upper upper middle middle lower middle lower upper upper upper upper upper upper middle middle upper class
bobmary: lower lower middle lower upper middle lower class
marianfrank: middle lower lower lower upper lower middle middle lower class
patibill: middle lower lower upper lower upper lower upper middle middle middle middle lower upper upper upper lower middle lower middle upper middle upper lower middle class
monicaluann: lower middle upper lower middle lower middle middle lower lower lower middle lower upper lower upper lower lower middle class
frankpati: upper upper lower upper middle upper middle upper middle middle middle lower upper middle middle middle lower lower middle lower upper lower lower middle class
garyanne: middle middle middle upper middle lower middle upper upper middle middle middle class
monacarl: lower upper middle lower lower lower upper lower lower middle lower upper lower middle lower middle middle lower class
dicktom: middle middle upper lower lower upper lower upper upper upper middle middle middle lower middle middle middle upper upper lower lower class
marycarl: lower lower upper upper middle upper lower middle class
williamjohn: middle upper lower upper upper upper middle lower lower lower middle upper upper upper upper lower upper upper middle lower lower upper lower class
stanrich: lower middle middle middle upper middle lower upper upper lower middle upper lower middle middle middle upper upper upper lower middle class
hansmark: lower middle middle middle upper middle middle middle middle class
beawendy: upper upper middle upper middle lower lower upper lower upper upper upper upper lower middle upper middle lower upper middle upper middle upper lower class
marianjohn: lower upper upper lower lower middle lower lower lower class
deannadana: lower lower lower upper middle upper middle upper upper upper middle lower upper lower lower middle middle middle class
deannamark: middle upper upper lower upper upper middle upper middle upper lower upper middle upper upper middle lower lower upper middle upper middle middle class
monicarich: lower upper middle middle lower lower middle lower lower middle lower middle upper upper middle lower lower middle lower lower upper lower class
rickbea: lower middle middle upper lower lower middle middle lower upper lower lower upper upper lower middle middle upper middle upper lower upper middle lower middle class
violetviolet: upper lower upper upper lower class
carlajack: upper middle middle middle upper upper middle lower lower middle lower lower middle middle middle lower lower lower middle upper class
violetjohn: upper lower upper middle upper upper upper upper lower lower middle upper middle middle middle upper upper upper middle middle lower middle lower upper lower upper class
danarichard: middle lower middle upper upper upper lower upper class
dickstanley: lower middle upper middle upper lower lower upper lower upper upper upper middle lower class
charlesrick: lower middle upper middle upper middle lower upper middle middle middle middle middle upper lower upper middle middle class
suemark: upper lower middle upper lower lower middle upper lower upper lower middle upper lower middle upper middle middle upper middle middle lower lower class
tommymona: middle lower lower middle lower upper middle upper middle upper lower lower upper upper lower upper lower lower upper lower class
jefftommy: upper upper middle upper upper lower lower middle class
franzmarian: upper lower middle upper lower upper middle middle upper middle upper upper middle lower upper middle lower lower upper upper upper middle middle lower upper class
carled: middle lower lower middle middle lower upper middle lower lower middle lower lower upper upper upper class
tomluann: upper lower upper upper upper class
peterfrank: upper middle middle class
markwendy: middle upper middle lower upper middle lower lower upper lower lower upper middle upper upper lower upper lower upper lower lower upper upper upper upper lower lower class
markbill: upper lower lower upper upper middle upper lower lower lower lower upper upper class
jackharry: middle lower lower lower lower lower middle middle upper middle lower middle lower lower upper upper upper class
danajack: upper upper middle middle middle middle middle upper upper lower lower middle middle upper middle middle middle middle class
carlrichard: middle upper upper middle middle upper upper lower upper class
bobluann: middle lower lower upper lower upper upper middle upper middle lower middle lower lower upper upper lower lower lower class
rickmarian: middle upper middle lower lower lower lower upper upper upper lower middle upper upper class
stanleyanne: middle lower middle lower middle upper lower upper middle upper upper middle upper middle middle class
luanngary: lower lower middle upper lower lower middle middle class
richcharles: lower middle lower lower lower middle middle lower middle lower middle class
beagary: middle upper lower lower middle middle upper class
richcarla: middle lower lower middle middle upper upper lower middle lower lower middle lower class
richardtommy: middle lower upper upper upper lower middle lower lower upper lower middle upper middle lower upper upper upper middle middle upper upper middle middle upper class
patitommy: lower middle middle middle upper lower lower lower lower lower middle upper class
garypeter: middle class
karldavid: middle lower upper class
luannluann: lower lower lower upper middle upper lower middle class
deannacharles: upper middle middle middle middle lower middle middle upper upper upper lower upper lower lower middle middle middle middle class
jackrich: lower middle upper upper upper middle lower lower lower lower upper lower lower class
stanarnold: lower lower middle lower lower lower middle upper lower middle middle middle middle middle middle middle lower lower middle lower lower lower upper middle middle lower class
stanleyjeff: lower lower lower lower middle lower upper middle upper upper upper upper middle lower middle lower upper middle lower lower upper middle upper lower lower upper lower class
danajose: lower middle class
monacarla: lower middle upper lower upper middle upper upper upper upper upper middle lower lower lower middle upper upper middle middle lower middle upper class
billfranz: upper middle middle lower upper lower upper upper lower lower upper upper upper lower middle upper lower upper lower lower middle middle middle middle middle class
markrick: lower middle lower lower upper upper middle middle lower lower upper class
danastan: upper lower middle lower lower lower upper middle lower lower upper upper upper upper class
deannatommy: lower middle middle upper middle upper lower upper class
harryrichard: middle class
josehans: upper lower lower upper lower middle lower middle lower middle middle middle upper lower middle middle upper upper lower upper middle lower upper middle lower middle middle class
bobfrank: lower middle upper middle middle upper middle lower lower lower middle lower lower upper lower middle upper upper upper upper upper class
monicawendy: upper middle upper middle lower middle middle upper upper middle lower middle upper class
marktommy: middle lower upper middle lower upper class
davidharry: middle upper middle lower upper upper lower upper middle lower upper lower upper upper lower upper upper upper lower class
garyluann: lower lower upper lower upper lower middle lower lower upper upper upper middle class
beadeanna: middle lower middle middle upper middle upper lower upper middle class
williamharry: lower middle upper upper upper lower middle middle upper upper lower middle upper middle lower middle upper lower middle upper upper class
suekarl: upper lower middle lower lower lower class
davidmary: lower middle middle upper upper upper lower middle middle lower class
edpatricia: middle middle middle middle upper middle middle middle upper lower upper upper lower lower upper upper middle middle upper upper lower class
carlapatricia: lower upper lower lower lower middle middle lower middle upper middle lower upper middle middle middle middle lower lower middle middle lower middle upper class
danaxavier: upper upper upper middle upper lower middle middle middle upper lower lower lower lower upper middle middle middle upper lower middle class
monicamonica: middle class
stanleypati: middle middle lower upper middle upper middle middle upper lower upper upper upper middle upper middle upper upper class
monadana: middle lower middle middle upper middle middle middle middle lower lower upper class
violetsue: lower lower middle lower lower upper class
franzrick: upper class
suebea: lower middle lower lower middle upper upper upper upper middle middle lower upper upper upper middle upper lower middle lower middle class
harrydavid: middle upper lower middle middle upper lower middle upper lower lower upper middle middle class
hansarnold: middle middle upper lower middle lower upper class
edanne: upper upper upper middle upper lower upper middle lower upper middle lower upper lower upper middle upper class
harryjose: middle upper lower upper lower upper upper upper middle upper lower class
arnolddavid: middle lower upper upper upper lower middle upper middle lower class
monapeter: middle lower middle middle middle lower middle upper upper upper middle middle middle upper upper middle lower lower lower class
deannajeff: lower upper lower upper upper upper lower upper lower lower lower lower upper lower middle upper upper class
johntom: middle lower upper class
luannjose: upper upper upper middle lower upper lower middle lower upper lower middle middle middle upper class
markmarian: middle upper lower upper middle lower lower lower middle lower middle lower lower upper lower middle middle upper class
jackfrank: lower upper upper middle middle upper middle upper upper upper middle middle lower lower upper upper middle upper class
franzdick: lower class
harrystan: upper middle lower lower lower upper middle middle lower lower middle lower upper upper lower lower lower upper middle lower upper middle lower upper lower middle upper class
charlesxavier: upper lower upper middle upper upper upper upper upper middle class
richardhans: middle middle middle lower middle middle middle lower middle middle lower middle upper middle middle upper middle upper middle lower middle lower class
luannjeff: upper upper upper upper upper lower middle upper upper upper lower upper lower lower lower upper middle upper upper middle upper middle class
stanleycharles: middle middle lower middle middle upper middle upper upper upper lower lower lower middle upper lower upper lower lower upper class
rickdeanna: lower middle upper upper upper lower middle lower middle middle lower lower lower upper lower class
karlstanley: middle lower lower middle upper lower lower upper middle middle middle middle upper lower middle lower upper class
richardfranz: middle middle upper middle lower upper upper class
arnoldmarian: upper middle middle lower class
bobjose: lower middle middle upper middle middle lower lower upper upper lower class
patriciawilliam: middle upper middle lower upper lower upper middle upper middle upper lower upper lower lower upper upper lower middle lower lower upper class
beastanley: upper middle middle lower middle lower lower lower middle upper upper upper middle lower middle lower middle lower upper middle lower upper lower lower lower class
peterbea: upper lower middle upper middle lower middle class
maryxavier: upper upper class
richdana: middle lower upper upper upper middle lower lower upper lower upper upper lower upper upper lower lower lower middle upper lower upper lower middle class
harrymarian: lower lower upper middle middle lower middle upper middle lower lower middle middle middle upper middle lower lower middle class
harryrich: middle lower upper lower upper middle upper lower lower middle lower upper middle lower middle lower upper upper lower class
bobanne: lower middle lower middle lower upper middle lower middle upper upper class
danaed: lower middle lower middle middle upper middle upper lower middle middle upper lower middle class
johndana: upper middle middle lower lower lower lower middle middle lower upper lower class
jeffbea: middle lower upper class
stanleystan: lower middle middle middle upper middle lower upper lower upper upper upper middle middle class
rickstanley: lower lower middle middle lower middle upper upper lower middle middle lower middle upper lower lower upper middle lower lower lower class
peterbob: lower upper upper middle middle lower upper middle middle lower upper middle middle upper upper lower class
johnjeff: middle upper lower lower middle lower middle upper upper lower upper lower lower lower lower middle middle middle lower middle middle class
richsue: upper lower lower middle lower lower lower upper middle lower lower middle middle lower upper upper middle middle middle upper middle upper class
maryjack: middle upper class
xavierhans: middle lower upper upper lower lower lower upper middle upper upper middle class
tomdick: lower lower lower lower lower lower middle lower middle lower lower lower lower lower class
franzmary: upper upper upper upper middle middle upper upper class
williamkarl: upper lower middle middle lower middle middle middle middle middle lower upper lower middle middle upper upper upper lower lower class
xavierstanley: middle middle upper middle upper lower upper lower middle middle middle upper lower lower lower class
wendypati: lower upper middle upper upper lower lower upper upper upper lower middle upper upper middle lower middle lower middle middle middle middle lower lower class
wendytom: middle upper upper middle lower middle upper lower middle upper middle middle middle upper middle middle lower lower lower middle class
edmona: middle upper lower upper middle class
deannaxavier: middle class
harrydick: upper lower lower middle middle upper middle lower upper lower lower middle upper middle middle upper upper lower upper lower lower lower lower middle upper upper class
jeffjeff: lower upper upper middle lower upper middle middle middle lower middle middle lower lower class
tomsue: upper middle upper upper lower lower lower middle class
deannabill: upper upper middle lower lower upper lower upper lower class
carlaxavier: upper middle upper middle upper upper lower lower lower lower lower middle lower middle middle middle middle middle middle middle lower lower lower class
jeffgary: lower middle upper middle middle upper lower middle upper lower class
patriciamary: lower lower upper lower middle middle middle lower lower middle lower lower upper upper lower upper lower class
williamdana: lower upper lower lower upper upper upper upper lower upper upper middle middle upper lower upper middle middle upper middle lower class
bobdana: lower lower middle lower lower upper class
billpeter: lower middle upper middle upper lower lower lower class
bobwendy: middle lower upper middle upper lower class
patimary: lower middle middle lower lower middle lower lower lower upper upper upper middle middle lower class
carlarich: middle upper middle middle middle middle middle upper upper upper lower class
tomviolet: lower middle lower lower lower middle middle lower middle lower middle upper lower middle lower lower class
mariansue: upper lower middle lower lower upper lower upper lower lower middle lower lower middle middle middle lower lower upper class
luanncharles: upper lower upper middle lower middle lower middle lower lower middle upper upper lower lower upper lower class
harrybea: middle lower middle upper lower lower upper upper lower upper upper lower middle upper middle lower upper lower upper lower lower upper upper class
markjohn: middle class
markjeff: upper middle middle middle lower upper middle lower middle middle middle upper upper middle lower lower middle class
annegary: upper lower middle middle middle lower upper upper middle upper upper upper upper lower upper lower lower middle class
frankharry: lower upper upper upper upper class
suewilliam: middle middle middle lower lower upper lower lower upper middle middle upper upper middle middle lower lower lower upper middle lower lower lower upper lower lower class
hansgary: upper upper lower upper lower middle upper middle class
frankgary: upper upper middle upper middle lower upper middle lower lower upper middle lower upper lower lower middle lower lower lower upper upper lower lower upper lower class
tomhans: middle lower middle middle upper class
markhans: middle middle lower upper lower upper lower upper lower upper lower middle lower lower upper upper class
davidtommy: middle lower upper lower lower middle upper middle middle middle upper upper upper class
suesue: middle class
patigary: lower lower lower upper upper lower lower middle lower upper lower middle upper upper middle middle middle lower lower lower middle middle upper middle lower upper class
johnxavier: middle upper class
davidjeff: lower middle lower middle lower lower lower class
danamona: middle lower middle middle upper lower lower middle middle lower middle lower upper middle upper middle upper class
peterjack: middle middle lower class
monicaxavier: upper upper lower upper class
frankarnold: lower upper lower middle upper lower middle middle upper upper upper class
edluann: middle middle middle lower upper upper lower upper upper middle lower middle middle upper lower lower middle upper lower middle middle lower lower middle upper class
davidcarla: middle middle upper lower middle upper lower lower upper lower lower middle upper lower lower middle upper middle lower lower class
stanleytommy: middle upper upper upper upper lower upper lower upper middle lower class
charlesmary: lower lower upper middle upper class
annearnold: lower upper lower upper middle upper upper lower upper middle upper upper upper middle class
maryfrank: lower lower middle upper lower lower upper upper middle class
carlluann: upper upper upper middle middle middle middle lower middle lower middle lower middle upper upper lower lower class
bobstanley: lower middle middle lower lower lower lower upper lower lower lower lower lower lower lower class
carlxavier: middle lower upper lower middle middle lower upper middle middle upper lower class
patriciacharles: middle middle class
luanned: middle lower upper middle middle upper lower middle middle upper lower upper class
carldavid: middle lower upper lower lower middle upper middle lower lower lower upper middle middle middle middle middle lower middle middle middle upper upper lower middle class
johnhans: middle upper middle lower lower lower lower middle class
richardmark: middle upper middle middle middle middle middle upper lower lower upper upper upper upper middle upper lower lower middle lower middle upper upper middle middle middle class
williamfranz: lower upper lower lower middle upper upper upper middle middle upper lower upper lower upper middle upper middle middle class
marianbob: middle middle class
carldick: lower upper middle lower upper middle middle lower upper lower upper middle lower lower lower upper upper middle lower class
frankbob: lower upper upper lower upper lower middle middle middle middle upper middle middle middle upper middle middle upper lower upper upper middle lower middle class
tombill: upper middle upper upper middle middle upper middle class
xavierrich: middle lower middle upper lower upper upper lower lower upper lower upper middle middle middle lower middle upper upper lower middle class
luannjack: lower class
carlfranz: lower upper middle middle lower middle lower upper lower upper upper class
deannabea: upper upper upper upper lower middle middle lower middle middle lower upper middle lower middle upper lower upper upper lower lower lower middle class
stanhans: lower middle middle middle lower lower middle upper middle lower middle lower lower middle class
stansue: lower upper upper middle upper middle upper middle lower middle lower upper middle middle upper middle lower upper upper upper upper upper upper upper class
carlgary: lower upper upper middle middle lower upper lower middle lower middle class
hansdick: upper lower class
jackrick: upper upper middle lower middle lower upper lower lower lower middle middle upper lower lower class
petermarian: lower lower upper middle upper middle upper middle lower middle middle middle upper class
richdavid: middle upper upper upper lower upper lower middle middle lower middle upper class
jackmona: upper lower class
marianrich: upper lower upper upper lower lower middle upper upper lower lower class
eddavid: upper upper upper middle lower middle lower upper middle upper middle lower middle middle lower lower upper upper class
tomarnold: lower middle class
stanbob: middle lower middle upper upper upper middle upper upper middle upper lower middle lower upper upper upper lower middle upper class
stanleykarl: lower upper lower lower middle upper lower upper upper class
garyjose: upper lower lower lower lower lower lower lower upper middle lower lower upper middle lower lower middle upper lower upper upper middle class
patriciajohn: middle middle lower middle upper upper lower upper middle lower lower middle lower upper upper lower upper lower lower class
carlacharles: upper upper middle lower middle upper class
stanpati: upper lower middle upper middle lower middle upper middle lower lower upper middle upper middle lower upper lower lower upper upper upper middle middle middle class
carlbill: lower middle class
billdick: lower middle lower class
wendyhans: upper upper middle middle lower lower lower lower lower middle lower upper middle middle lower upper middle upper middle lower upper class
stanleygary: lower lower upper upper middle lower middle upper upper lower middle lower upper lower class
beabea: lower upper upper upper upper lower middle middle upper class
monawendy: middle upper lower lower lower middle lower middle lower upper middle lower upper middle upper upper class
dickluann: upper lower middle upper middle lower upper lower lower lower upper middle upper upper middle upper lower middle upper lower upper upper lower class
wendycarla: middle upper lower lower class
monicakarl: middle lower middle middle middle class
suestan: upper middle upper middle lower middle upper lower middle lower middle upper lower lower lower middle lower lower middle class
monadeanna: upper upper middle lower upper middle lower upper middle lower upper middle class
davidbob: lower upper lower upper middle middle middle middle lower lower upper middle upper lower middle lower upper upper lower lower upper middle class
deannajohn: lower lower class
monabob: upper lower lower middle middle lower lower upper lower lower upper middle lower middle middle upper lower lower upper lower upper middle class
richmary: upper upper middle upper middle middle upper middle lower upper upper middle upper lower lower middle lower upper middle lower lower lower lower upper class
jackmarian: middle lower upper lower middle middle lower upper class
harrymona: lower lower middle upper lower lower upper lower lower class
deannacarl: lower middle lower middle upper upper middle lower middle lower upper lower middle upper upper upper upper class
patisue: lower upper lower upper upper upper upper lower middle lower middle class
xavierluann: lower lower upper upper lower middle upper middle upper middle middle upper upper class
franzjack: middle lower upper middle lower upper middle upper middle upper middle middle class
davidxavier: upper middle class
luanndavid: lower upper lower lower middle upper middle middle upper lower lower middle class
carlmona: upper upper middle middle middle upper lower upper class
hansdeanna: upper middle lower lower middle upper upper upper lower lower lower middle upper upper upper middle middle upper upper class
frankcarl: lower upper middle lower upper lower middle upper lower middle upper lower upper lower lower lower middle upper lower middle middle upper upper lower middle upper lower class
billgary: upper lower lower middle middle lower upper upper lower upper class
mariantommy: lower lower middle upper lower middle middle upper upper class
patriciadeanna: middle lower lower middle upper upper upper upper middle upper upper upper upper middle upper lower upper middle lower lower class
joseanne: upper middle upper middle middle middle lower middle lower lower upper class
carlaanne: upper middle middle lower lower upper lower middle middle upper middle upper class
anneviolet: middle lower middle middle middle class
davidjack: middle upper lower lower lower lower lower upper middle upper middle middle middle upper class
williamfrank: upper lower lower lower lower lower class
richfrank: middle upper upper middle upper middle middle upper upper lower class
patidana: middle middle middle middle upper middle upper middle middle lower lower middle middle middle middle lower middle middle lower upper upper lower middle upper lower upper class
garyxavier: middle upper middle lower upper lower lower upper middle middle upper lower middle lower lower middle middle upper class
carljose: middle middle middle middle lower middle lower middle lower middle middle upper lower lower middle middle middle upper lower upper lower lower middle class
williambill: upper middle middle lower lower lower middle upper lower middle lower middle lower lower lower upper lower middle middle lower middle lower middle lower middle class
arnoldarnold: lower lower lower lower lower middle class
hanshans: lower middle class
karlgary: upper lower middle middle middle middle upper middle middle lower middle class
monicasue: lower lower middle middle middle upper upper middle middle upper middle upper middle class
xavierfranz: middle middle upper upper lower upper upper lower lower middle upper upper lower upper upper lower lower lower lower lower class
stanpeter: lower middle upper upper upper upper middle lower lower lower lower upper upper lower lower lower upper middle upper lower middle upper upper lower lower upper upper class
harrykarl: upper upper upper lower class
davidwendy: upper lower middle middle lower lower upper upper lower upper upper middle lower lower lower middle class
stancarla: middle lower lower middle middle middle upper upper lower middle middle middle middle upper lower lower upper lower upper upper middle upper middle class
frankjohn: lower middle upper upper middle middle middle upper lower lower lower middle upper middle middle upper lower middle class
stanjose: upper upper lower class
sueed: upper lower lower upper middle lower middle upper lower upper lower middle middle lower lower upper lower lower upper upper upper middle middle class
violetfrank: lower upper middle middle lower lower upper middle middle lower lower lower middle upper upper upper middle upper upper lower lower class
johnpeter: lower lower upper upper middle lower lower lower upper middle middle middle lower middle lower upper upper lower lower upper class
luannanne: middle lower lower lower class
garyfrank: upper upper lower lower middle upper lower upper upper middle middle lower lower middle middle lower middle middle upper lower upper class
bobxavier: middle lower upper middle lower lower lower upper middle lower upper middle middle lower upper upper lower upper middle lower upper lower middle lower middle upper class
peteranne: middle upper middle lower middle middle middle lower lower upper class
patibob: lower middle upper middle middle upper middle upper upper middle upper lower upper lower middle middle upper upper middle middle middle middle middle upper lower upper class
tommypatricia: upper lower upper upper lower lower upper middle upper middle middle upper middle lower middle lower middle lower middle lower lower upper middle middle lower upper class
mariangary: middle lower lower middle upper middle middle upper upper upper middle middle lower upper lower middle upper middle middle middle class
stanbea: upper middle lower middle lower middle middle lower middle middle middle middle lower middle upper lower upper lower lower upper class
arnoldcharles: middle middle lower middle upper upper lower middle lower upper upper upper middle middle lower lower middle lower lower middle upper lower class
wendydana: lower lower middle class
luannmark: middle upper middle upper lower upper upper upper lower upper class
bobpati: lower middle lower middle upper lower lower middle upper lower lower lower middle middle middle lower upper middle middle lower lower middle class
annesue: middle upper middle upper middle upper lower middle upper lower lower lower middle lower middle class
markviolet: lower upper middle middle lower lower upper lower upper upper middle lower upper lower middle upper lower lower lower middle lower upper class
davidhans: lower upper lower upper lower lower upper class
harryanne: upper upper lower lower middle upper upper middle middle middle lower lower middle middle lower middle lower lower class
karlcarla: middle upper lower upper upper middle lower lower upper lower middle middle class
beadavid: lower upper middle lower middle middle lower upper upper lower middle middle class
beabill: middle lower lower lower upper middle upper middle upper upper middle lower lower lower middle upper lower lower middle middle class
xavierjose: middle upper middle middle upper upper upper lower middle class
richdeanna: lower lower lower lower upper lower lower lower middle lower middle middle lower middle upper upper upper upper lower upper lower middle upper upper lower lower class
richtom: middle upper lower middle middle lower lower middle upper lower middle lower upper upper upper middle upper class
carlfrank: lower middle upper lower upper lower upper upper lower lower middle lower middle lower upper lower upper upper class
violetkarl: lower middle lower upper class
jeffwendy: middle upper lower lower lower upper upper lower upper lower middle middle upper lower middle middle upper class
charlesbill: middle middle upper upper lower middle middle middle upper middle lower middle upper lower middle upper middle lower lower middle lower middle lower upper upper lower lower class
edarnold: middle lower upper middle lower middle upper lower middle lower middle upper upper upper upper upper class
beamarian: lower lower upper lower upper upper lower upper middle middle middle upper lower upper middle lower class
markrich: lower middle lower lower middle middle upper middle lower middle upper lower class
jeffmona: upper upper lower lower middle middle upper middle middle middle upper lower upper lower lower upper class
patiluann: middle lower lower lower lower middle class
jackmark: middle upper upper upper upper middle middle middle middle upper class
mariantom: middle middle upper lower upper upper middle upper lower lower upper lower lower upper lower lower class
jeffrich: lower middle middle upper lower upper middle upper lower middle lower lower class
wendyed: middle upper upper upper lower upper lower upper lower class
marianjeff: lower middle upper upper lower middle lower upper upper middle middle middle lower upper middle upper middle lower class
tomcarl: upper upper middle upper lower lower middle lower middle lower upper middle upper class
tomjohn: lower middle lower lower upper middle upper upper middle lower lower upper middle upper middle upper middle upper lower class
carlarick: lower lower middle lower upper middle upper middle middle upper lower upper lower middle middle lower lower class
garyviolet: lower upper middle upper lower middle lower upper upper upper middle middle lower lower upper lower upper lower middle upper class
franzstan: middle upper upper upper middle middle upper lower lower class
violetmonica: lower upper lower upper lower upper upper upper upper upper middle middle lower upper upper middle class
monapatricia: lower middle upper upper upper upper upper upper upper middle middle lower upper upper middle upper lower middle upper middle upper class
monicapatricia: lower upper lower lower upper lower upper middle lower lower middle upper upper middle middle middle middle lower upper upper upper lower middle upper lower class
garydana: middle middle upper upper class
maryrick: lower upper upper upper lower upper middle upper upper lower middle upper lower upper upper upper class
jackpatricia: middle upper middle middle lower middle lower middle upper middle upper middle middle upper lower upper upper lower lower class
danajohn: middle middle upper middle middle lower upper lower lower middle lower lower lower upper middle middle lower lower upper lower middle lower class
peterpeter: middle lower middle class
xaviermona: lower upper lower middle upper lower lower middle middle lower upper lower upper lower lower class
violetmarian: middle lower middle lower class
jackbea: middle lower middle middle upper middle middle upper middle upper upper lower middle middle upper class
tommydavid: middle class
monicamary: upper middle middle lower upper lower upper lower lower upper class
stanstanley: middle lower upper upper upper middle upper class
jackjohn: lower upper lower lower lower middle upper upper upper middle lower middle middle lower lower lower upper middle upper upper upper middle lower class
williammary: middle lower upper class
monicamark: lower lower lower upper middle lower lower lower upper class
carlsue: middle class
dickmark: upper middle upper lower class
deannamona: middle middle middle class
josepati: lower upper upper upper middle upper lower lower upper middle upper middle upper middle middle lower upper class
maryrich: upper upper middle middle upper middle lower lower middle upper upper upper upper upper middle upper middle middle lower lower upper lower lower lower class
monatom: upper upper upper upper upper lower upper upper lower upper lower upper lower middle lower upper upper upper lower upper lower class
patiarnold: lower middle lower class
carlwendy: lower upper upper middle middle lower middle upper upper middle lower lower class
richardcharles: lower middle lower lower upper upper upper middle middle lower class
franzsue: upper middle upper middle upper middle upper middle lower upper middle upper class
patijeff: lower class
tommypeter: middle lower middle class
joserichard: upper upper class
tommyjeff: lower middle class
carlstanley: lower lower upper lower upper middle lower upper middle lower upper upper upper class
monamark: upper upper upper upper lower middle middle lower upper upper lower upper middle lower middle middle upper upper middle middle upper middle lower middle middle lower class
hansjeff: lower upper upper lower upper lower middle lower upper upper middle upper lower middle lower middle lower lower class
tommyanne: lower middle lower upper lower upper middle middle lower upper middle upper upper lower middle upper upper lower middle middle lower middle lower class
marykarl: lower upper upper upper lower upper middle middle lower middle lower lower lower middle upper middle upper middle middle middle lower upper lower class
patricialuann: middle upper lower middle upper middle lower middle lower middle lower middle lower lower lower lower class
billbill: lower middle middle middle middle upper middle middle lower upper middle lower lower upper lower upper upper middle upper upper middle upper upper lower lower lower middle class
jeffstanley: upper upper upper lower middle middle lower lower lower lower upper lower lower middle lower upper lower upper lower lower lower lower middle middle middle middle upper class
annetommy: middle class
josewilliam: lower upper lower lower lower upper middle upper lower middle middle lower upper middle middle middle upper upper lower lower upper middle upper upper lower lower lower class
richardsue: upper upper middle lower middle lower upper middle middle middle class
marianmarian: lower lower middle upper middle middle lower middle upper lower upper lower lower middle upper upper upper middle class
deannastan: upper middle middle middle upper lower lower middle upper lower lower class
monasue: upper upper middle middle middle middle lower lower upper class
charlespati: upper lower middle class
karlluann: lower lower lower lower middle middle lower lower lower lower upper upper lower upper middle lower middle upper middle middle lower middle middle lower lower class
marycharles: middle upper upper middle lower lower middle middle lower middle upper upper lower middle middle upper lower middle lower lower upper upper middle lower lower middle lower class
wendywilliam: middle middle upper middle lower middle middle middle upper upper lower lower lower middle middle lower lower middle middle class
maryed: lower lower lower upper lower lower middle upper lower class
arnoldviolet: upper lower upper lower lower lower lower lower lower lower middle upper upper upper upper upper upper upper lower upper middle class
carlrick: upper middle middle upper middle middle upper middle lower middle middle upper lower middle middle upper lower upper lower lower upper upper class
patipati: middle middle lower lower upper upper middle lower middle upper upper lower upper middle class
arnoldanne: lower middle lower lower middle lower middle lower middle middle middle upper upper middle middle middle lower middle lower lower middle middle lower lower upper lower middle class
stanleyfranz: upper middle middle middle middle lower middle upper lower lower middle lower class
violetmary: middle upper middle lower middle upper upper upper upper upper middle upper upper middle lower upper class
billtommy: lower lower lower upper middle class
marytommy: middle lower lower upper middle upper upper middle lower lower middle middle upper upper upper lower upper class
markpeter: middle middle middle lower upper middle middle upper middle lower middle upper lower middle middle lower class
billarnold: upper upper lower lower lower upper middle upper upper upper middle middle lower middle upper upper lower middle lower upper class
suedana: middle middle lower upper lower middle middle middle lower lower middle lower middle upper lower upper middle upper lower lower middle upper middle upper upper middle class
hansjohn: upper middle lower lower middle upper upper lower upper upper middle middle upper lower upper class
tommyarnold: upper upper middle upper upper middle middle lower upper upper upper lower middle upper middle lower class
beatom: lower middle middle lower middle middle middle upper lower lower lower class
beapeter: middle middle middle upper lower upper lower upper upper upper middle upper middle upper lower lower middle lower upper middle upper upper class
bearichard: lower middle middle middle upper lower lower class
carlcarl: upper lower upper lower upper upper middle lower upper lower lower upper middle middle lower middle middle upper lower upper middle lower upper middle upper middle class
harryed: middle upper middle upper lower lower middle upper middle lower upper lower upper class
richpeter: upper middle upper lower middle upper upper class
danadick: upper upper upper middle upper lower lower middle lower lower upper middle lower upper middle lower middle lower upper lower middle lower middle lower class
stanjack: upper middle lower upper lower lower upper upper upper lower middle lower lower lower class
tommyed: lower middle middle lower lower middle lower upper middle middle middle upper lower lower upper upper lower upper lower lower class
franzdana: lower lower middle upper upper upper upper upper upper middle upper middle middle upper middle middle lower middle upper middle middle middle upper lower lower middle lower class
patihans: lower middle lower middle upper upper upper upper lower middle middle middle lower lower lower lower middle upper lower lower lower upper lower upper class
markcharles: upper lower upper upper upper middle lower lower middle upper middle lower upper upper lower lower middle middle upper upper upper middle class
carldeanna: upper upper lower lower lower class
xavierviolet: upper lower upper lower lower lower upper middle middle upper lower lower lower middle class
violetwilliam: lower lower lower class
monarick: middle middle middle middle lower middle middle middle upper middle middle lower lower middle upper upper middle lower upper lower upper upper middle lower class
rickmark: lower lower upper upper lower lower lower upper middle lower middle middle middle middle middle upper upper lower upper class
luannkarl: upper middle lower lower upper lower upper upper middle lower middle lower lower upper middle upper upper upper upper class
eded: lower lower upper upper lower lower lower class
danaviolet: middle lower upper upper upper upper lower upper upper middle middle middle middle middle middle upper upper lower upper upper lower middle lower lower upper upper middle class
carlawendy: upper upper upper upper lower middle middle lower lower middle upper lower lower upper upper upper lower lower middle lower lower class
jackwendy: middle upper upper lower upper lower lower middle lower upper class
billxavier: upper lower upper upper middle lower lower middle upper upper middle class
marypati: lower upper upper middle upper middle upper lower middle lower upper upper upper middle middle upper lower upper upper upper middle middle middle middle lower upper lower class
patidick: middle upper middle lower lower upper lower class
jeffjack: upper lower middle middle middle upper lower upper upper middle lower middle lower middle middle lower lower class
frankstan: middle middle middle middle lower lower upper lower middle lower upper middle upper middle lower upper upper lower middle middle middle lower lower upper upper middle class
dickjack: middle middle lower middle lower lower upper lower lower upper lower lower lower upper middle upper lower middle upper class
petermonica: lower middle lower class
edfrank: middle middle upper upper class
monamarian: middle middle class
harryfranz: lower middle middle upper lower upper upper upper middle middle lower lower lower middle class
monicastan: upper upper upper middle lower upper upper middle middle lower upper middle upper upper lower upper middle upper lower lower lower lower middle class
johnstan: lower lower lower upper upper lower lower middle upper lower lower lower lower middle upper class
charlesrich: middle lower upper lower upper lower upper lower middle class
stantommy: middle upper middle lower middle upper upper upper upper lower middle middle middle class
rickcarl: upper upper upper class
suearnold: upper lower lower upper middle upper upper lower lower middle upper middle lower middle upper lower upper middle upper upper lower upper lower lower middle middle class
harrystanley: lower lower lower lower lower lower middle upper lower upper upper middle middle lower upper upper middle middle upper lower middle middle class
maryjohn: middle middle middle lower middle lower middle lower lower lower lower middle lower middle upper class
garykarl: lower lower lower lower upper middle middle upper lower middle upper lower lower lower upper upper upper middle upper middle lower lower lower upper upper class
luannmary: lower upper lower lower lower upper middle lower lower middle middle upper upper lower class
marianpatricia: lower middle lower lower upper lower lower middle upper middle upper lower upper middle middle upper class
franzbill: lower middle middle middle middle middle middle class
richstan: middle lower upper upper middle upper upper middle middle upper middle lower upper lower middle upper lower class
marymary: upper upper middle class
arnoldjeff: lower upper middle upper upper lower middle lower middle lower lower lower lower lower upper lower middle lower class
tomdana: upper lower lower lower upper lower middle upper upper middle class
xaviermark: upper middle middle upper middle middle lower upper lower upper lower lower upper middle class
danabob: lower upper middle upper middle upper lower middle middle middle upper lower middle class
xavierjohn: upper middle middle upper middle middle middle middle upper lower middle lower lower lower middle lower lower upper lower middle class
richardfrank: middle middle lower middle middle middle lower lower middle upper upper upper upper class
jackkarl: lower upper upper lower middle upper middle lower lower upper middle upper class
harrybob: middle upper middle lower upper middle lower middle middle lower middle upper upper upper middle upper upper middle middle middle lower middle upper middle upper middle lower class
karldick: middle middle middle middle upper middle middle middle middle middle lower lower lower middle middle upper lower middle middle lower middle middle upper lower middle upper class
billbob: upper class
williamrichard: lower upper upper middle lower middle middle upper middle upper upper upper upper middle upper upper lower lower middle middle lower middle lower upper lower class
beacarla: upper upper middle upper upper lower middle lower upper lower upper middle middle class
suejohn: middle middle upper upper upper middle upper lower middle middle upper upper upper upper class
dickrich: lower upper upper lower lower lower class
arnoldfrank: middle lower middle upper middle middle lower class
xaviercarl: upper middle lower upper upper lower lower upper middle lower lower upper middle class
patimarian: lower lower upper lower upper upper middle middle class
jefftom: middle upper upper lower lower lower middle middle middle middle lower lower class
charlesharry: upper upper upper class
wendyrich: middle lower upper upper upper upper upper middle lower lower middle lower upper middle upper upper lower upper middle middle lower lower upper upper lower middle class
jackbill: lower middle upper lower lower lower middle middle upper lower middle middle upper class
patijose: upper middle upper upper upper lower lower upper lower lower lower upper lower lower lower class
davidrick: middle lower lower lower lower class
marianxavier: middle upper lower upper lower middle lower lower middle class
richxavier: middle lower lower lower lower upper upper middle middle class
violetmark: upper upper upper lower class
johnpati: lower upper lower lower middle lower middle lower upper middle upper upper lower lower lower class
davidbea: middle middle lower upper upper lower lower lower upper upper middle lower class
johnmonica: upper middle lower lower lower upper middle lower lower upper middle middle upper class
luannstan: lower lower upper middle lower upper lower lower middle lower lower upper upper lower upper middle middle middle upper upper lower upper lower class
josemona: lower upper lower middle middle lower middle class
monajeff: middle lower middle middle lower lower middle middle upper upper lower middle middle middle lower upper lower lower lower middle middle upper middle lower middle middle lower class
johnmary: upper upper upper middle upper upper lower upper class
xaviercharles: middle upper middle upper middle upper middle lower lower middle upper middle middle lower middle lower upper middle class
luannmonica: middle middle upper lower middle lower upper upper middle middle upper middle lower lower middle upper middle middle middle upper upper class
davidfranz: upper upper middle lower middle middle upper middle lower middle lower middle middle lower upper lower lower middle upper lower class
hanspati: middle middle middle middle middle middle middle middle middle middle middle middle upper middle lower upper lower upper upper upper class
edgary: middle middle lower class
luannstanley: upper middle lower lower middle lower middle lower middle upper middle lower upper lower upper middle upper lower middle lower lower upper lower class
garyharry: middle lower lower lower lower upper middle lower upper middle middle lower lower lower lower middle lower lower upper class
markrichard: middle lower class
petertommy: upper lower middle upper middle upper middle middle upper class
patriciarichard: middle middle lower upper lower lower lower upper middle middle middle class
garyarnold: upper lower lower upper middle lower lower class
harrybill: upper upper middle lower middle middle class
tommyjack: middle upper lower upper middle upper middle middle middle lower upper upper lower lower middle middle upper lower middle upper lower upper upper upper class
arnoldbea: middle lower upper upper upper upper middle lower lower middle middle lower upper middle middle middle upper upper upper upper upper middle upper upper lower class
danarick: lower lower middle middle middle upper lower upper upper upper upper middle upper lower upper middle upper middle lower middle middle upper upper upper upper middle class
patriciahans: lower upper middle lower middle lower middle middle lower middle upper lower upper upper upper lower upper lower lower lower class
frankpeter: lower lower middle lower middle lower middle middle class
johnstanley: upper middle upper lower upper lower lower middle lower class
violetgary: middle lower upper middle middle upper lower middle lower middle upper upper lower lower upper middle middle upper middle upper upper middle lower lower middle lower class
patied: middle middle lower lower middle middle upper lower middle middle upper lower middle middle middle lower middle upper lower lower middle upper lower class
charlestommy: lower upper middle middle lower middle lower lower upper lower lower middle middle class
edwendy: middle middle upper class
suexavier: upper upper upper upper upper upper lower middle upper middle lower class
richardstanley: lower upper upper lower lower middle middle upper upper upper lower middle lower lower lower middle upper middle middle lower lower middle upper upper upper upper lower class
franzbea: lower upper middle upper upper upper upper lower middle class
peterarnold: lower middle middle upper upper upper upper upper middle upper lower upper middle lower middle lower middle lower class
richardbob: upper lower lower upper upper middle upper lower lower class
tomcarla: upper upper lower lower middle middle middle lower middle lower middle upper lower class
billmona: upper upper middle middle middle middle middle lower lower upper lower middle class
josefranz: middle upper lower middle upper lower middle middle lower upper class
patriciapeter: lower upper upper lower lower upper upper middle class
edcarla: upper middle upper lower upper middle upper upper lower middle lower middle lower upper lower middle upper upper lower lower upper lower upper upper lower class
charlesmark: lower upper upper upper middle middle upper upper lower class
suepati: lower middle upper upper middle lower upper lower upper lower lower upper upper upper class
johnsue: middle upper upper upper middle upper upper upper upper lower upper upper middle middle lower upper lower middle upper lower middle class
williampeter: lower upper lower upper middle middle middle upper middle lower lower upper middle lower lower lower middle middle lower middle lower class
wendyjeff: middle lower lower middle class
rickwendy: upper upper upper lower middle lower lower upper upper middle lower middle middle middle middle upper upper lower upper middle lower class
richbea: upper upper upper upper upper upper upper upper upper upper lower middle upper upper upper lower lower lower middle lower upper class
billfrank: upper upper upper upper upper lower upper middle upper middle upper lower lower upper upper class
violetcarl: upper lower middle lower lower class
arnoldsue: lower lower middle middle upper middle middle upper middle lower middle lower upper lower middle upper lower lower lower lower class
frankfranz: middle middle lower upper middle upper upper upper lower upper middle middle upper upper middle lower upper middle upper upper lower lower middle middle middle class
monicamona: lower class
carlahans: lower lower class
xavierstan: upper upper middle middle middle middle lower upper lower upper lower lower middle lower upper upper class
markdeanna: upper upper upper lower class
edwilliam: middle upper upper middle lower class
carlabob: upper lower upper middle lower lower lower middle upper lower lower class
harrymary: lower middle middle lower lower lower middle lower upper upper lower lower middle lower class
billpati: upper lower lower upper lower upper class
billjose: lower lower lower upper middle middle middle lower upper middle middle lower class
violetpati: middle middle upper upper upper lower middle upper class
frankdavid: upper middle middle class
tomharry: middle lower lower middle middle middle lower upper upper upper upper middle lower class
rickviolet: upper lower middle lower middle middle upper lower upper lower upper lower class
bobtom: lower middle class
beajohn: middle middle middle upper lower lower upper lower middle middle upper upper upper upper lower lower middle lower lower upper class
beaanne: upper middle class
maryrichard: middle middle middle middle lower class
tomwilliam: middle lower middle middle middle middle upper upper lower upper upper upper middle lower middle middle lower lower upper lower upper class
arnoldstan: upper upper lower upper upper middle middle upper upper lower middle upper lower upper class
johnjack: middle lower middle middle lower lower upper lower lower upper lower upper middle lower upper middle lower middle class
dickdeanna: lower lower middle middle middle middle lower upper lower middle lower middle upper upper upper class
bobjohn: middle middle middle upper upper upper upper upper upper upper middle lower lower class
carlamary: middle middle middle middle middle class
annestan: lower middle lower middle upper lower lower lower lower lower upper lower lower lower upper middle class
garydick: middle middle middle middle middle upper lower upper lower upper middle upper middle class
annerick: middle lower upper upper lower middle lower lower lower lower upper upper middle lower middle class
luannharry: upper lower lower upper lower class
billbea: middle upper lower lower upper lower lower upper upper lower middle lower class
suemonica: middle lower lower lower upper lower upper upper upper lower lower lower class
monacharles: upper class
richardcarla: lower class
marianmonica: middle lower lower upper lower upper lower class
edfranz: upper lower upper middle middle middle upper lower lower upper upper lower middle class
eddana: lower lower lower lower middle class
richardpeter: middle lower upper middle middle middle middle middle middle upper lower middle upper middle upper upper class
jackluann: lower upper lower middle upper middle lower middle lower lower upper lower upper lower class
williamjack: upper upper lower middle middle middle middle upper upper lower upper middle middle middle middle upper upper upper middle middle lower middle lower middle class
joserick: lower class
jackdeanna: middle upper middle lower upper lower middle upper middle lower middle middle upper lower upper upper middle lower middle upper lower lower class
marysue: upper upper lower upper upper lower middle middle upper middle class
violetrich: lower lower middle upper middle middle middle upper middle middle upper class
garytommy: middle lower lower middle middle upper lower upper lower lower lower middle upper lower middle upper upper upper lower lower upper middle class
richardmonica: lower upper class
josedavid: lower upper upper lower lower upper lower upper middle middle lower upper lower lower lower upper middle middle middle upper upper upper upper middle class
rickhans: upper upper middle lower upper middle lower lower middle upper upper upper lower lower lower lower lower lower middle lower class
tommary: middle upper lower class
richarddana: lower lower middle middle upper middle class
johnwendy: middle lower lower upper lower upper lower upper middle middle lower middle middle middle upper middle lower upper middle class
richmonica: upper middle upper class
xavierrichard: upper lower middle upper middle lower middle upper upper class
williampatricia: upper class
xavierdeanna: lower middle lower upper lower lower lower lower lower lower upper class
maryfranz: lower upper lower middle middle upper upper lower upper lower upper middle middle middle lower lower middle middle class
suewendy: upper upper upper middle lower lower lower upper middle middle middle upper upper middle middle middle class
suejose: upper middle middle middle middle middle upper upper lower upper middle middle lower lower middle middle upper upper upper middle upper middle lower upper upper lower class
tomfrank: middle middle lower middle upper lower upper upper middle lower upper lower middle class
danawendy: lower lower lower upper lower middle lower middle middle lower upper middle upper upper middle middle upper upper middle middle middle upper class
carlajeff: middle middle class
suedeanna: upper lower upper middle middle lower lower middle lower lower lower upper lower lower middle upper upper upper middle upper upper lower middle lower upper class
patriciafranz: lower class
beatommy: middle middle middle middle middle upper upper middle middle middle middle middle middle lower lower middle lower lower upper lower upper middle upper middle middle middle middle class
harryjeff: upper middle lower upper upper upper upper lower class
carlakarl: upper lower upper upper upper class
jeffcarla: lower lower lower lower middle lower upper upper middle upper middle middle lower lower lower middle lower upper upper lower lower upper upper class
carlmarian: lower upper lower lower upper lower upper upper lower lower middle lower upper upper lower middle middle upper middle upper upper middle lower middle upper class
suepatricia: upper lower upper lower upper lower middle lower middle middle lower upper lower upper lower upper upper upper lower lower upper middle class
richardpatricia: lower middle lower upper lower middle middle upper lower upper middle upper upper middle middle middle middle lower lower lower upper lower lower upper class
carlharry: upper lower upper class
bobharry: middle middle middle upper middle lower middle upper middle middle upper middle lower lower lower lower middle middle upper middle class
karljack: middle lower lower lower upper class
bobrich: upper upper lower lower lower upper class
patriciacarla: middle lower lower upper middle middle upper middle lower upper upper upper upper class
danawilliam: lower upper upper lower class
arnoldrick: upper middle lower middle middle lower lower upper lower lower lower lower lower upper lower lower lower lower class
tommyjose: middle upper middle upper upper upper lower middle middle middle upper upper upper upper upper upper lower class
franztom: upper lower upper lower middle middle lower lower middle upper upper middle lower middle lower middle lower middle upper lower upper upper upper middle middle upper class
deannamarian: lower lower lower lower lower lower middle upper lower middle lower lower middle middle middle middle lower middle upper class
marystanley: middle middle upper middle lower lower lower lower upper upper lower lower upper lower lower upper lower lower upper middle class
billdana: lower middle lower middle middle upper upper lower middle upper lower upper upper middle lower lower middle lower upper class
patimona: lower lower lower upper upper class
garyrichard: upper upper middle upper upper lower lower upper lower middle lower middle upper upper upper lower middle lower middle middle middle middle upper class
bobbea: middle middle upper lower lower upper middle lower upper class
richardarnold: upper upper middle lower lower upper upper lower lower upper upper lower upper upper middle middle middle middle lower class
violetjose: upper upper middle lower class
violetjack: middle middle upper upper middle lower upper upper middle upper lower upper class
tomdavid: lower upper upper upper middle middle middle lower upper lower lower lower middle middle middle upper upper middle upper lower lower lower lower middle lower upper middle class
anneed: lower upper middle class
johnrichard: upper upper middle lower upper upper upper lower middle upper middle lower middle lower lower lower lower lower lower upper lower middle middle class
deannastanley: upper middle lower middle upper middle lower upper class
peterharry: lower lower middle upper middle lower lower middle middle middle middle class
carlasue: upper lower lower class
tomstan: middle upper lower lower middle upper lower upper middle upper lower middle middle middle lower class
mariandavid: lower middle middle lower middle upper middle middle lower middle middle middle upper lower upper middle lower lower middle lower class
dickjose: lower middle middle lower upper upper upper upper lower lower upper middle lower class
carlawilliam: lower class
charlesstanley: lower upper lower upper upper lower upper upper class
beajeff: middle lower middle middle middle middle lower class
rickkarl: upper upper upper middle middle middle lower lower middle middle middle middle lower upper lower lower lower upper middle upper middle middle upper upper middle lower lower class
annedavid: upper middle middle middle lower lower class
harrysue: lower middle middle upper upper lower upper middle upper class
patriciasue: middle upper lower upper upper middle middle middle upper upper lower lower class
monicagary: upper middle lower lower upper middle lower upper upper lower upper middle class
marianwilliam: middle upper upper upper lower upper upper upper upper lower middle lower upper lower upper middle middle middle middle upper class
monafrank: lower upper lower lower lower upper middle middle middle upper middle lower middle upper middle lower lower upper middle middle middle middle middle lower class
tomanne: middle middle middle middle upper upper lower lower middle upper class
jeffpatricia: lower middle upper upper upper middle middle class
harryxavier: middle middle lower middle middle lower middle lower lower lower lower class
billsue: lower lower middle lower lower upper middle upper lower lower lower lower upper middle upper lower lower lower middle upper middle upper middle lower upper class
karlpatricia: upper middle lower upper middle lower middle lower lower lower upper lower middle middle lower upper upper upper upper lower lower upper middle upper upper lower class
franzrichard: upper lower upper upper middle upper upper middle upper middle middle lower lower upper middle class
bearich: lower middle middle middle middle lower lower lower middle middle middle lower lower middle lower middle upper class
patriciaanne: upper lower lower lower upper lower lower upper class
garybob: lower lower lower middle middle lower upper lower class
jeffrick: upper upper lower middle middle upper middle middle middle lower class
monicabea: upper middle lower middle lower middle lower upper class
carlamark: lower upper lower lower upper lower lower lower upper middle upper class
hansviolet: lower lower upper middle middle lower lower upper upper middle upper middle lower lower upper class
marycarla: upper lower middle lower middle upper lower lower lower class
johncharles: lower upper middle upper middle middle lower upper upper lower upper lower upper upper lower upper upper middle lower upper lower upper lower upper middle middle class
monicacarla: lower middle middle middle upper lower middle middle middle lower upper lower lower upper middle lower upper lower class
monamona: middle upper upper middle upper upper upper middle lower middle class
franzcarla: middle upper lower upper class
joserich: lower lower lower middle lower middle middle upper upper class
jackhans: middle upper upper upper upper upper lower lower lower upper upper upper upper lower middle upper upper lower upper class
johnfranz: upper middle upper lower lower middle lower middle upper upper lower upper upper middle class
hansjack: lower upper lower lower middle upper lower middle upper middle class
richrick: upper middle lower upper upper middle lower lower lower upper upper lower class
carlarnold: lower class
dickjeff: middle lower upper lower class
bobrichard: middle upper upper lower middle middle upper lower lower upper middle upper middle middle middle class
violetjeff: middle middle lower upper middle lower middle upper lower middle lower upper lower upper class
frankviolet: upper middle middle upper middle middle lower lower class
jackcarla: middle lower lower class
edtommy: upper upper middle class
monicatommy: middle middle lower lower middle middle upper middle lower lower upper lower class
tommyfranz: upper upper middle upper lower middle lower upper lower class
stananne: lower lower lower upper class
eddeanna: middle class
tomjack: middle middle lower upper upper middle upper upper lower middle lower upper upper middle middle lower lower upper lower middle lower upper lower lower lower lower class
bobgary: upper lower lower middle upper upper upper middle upper upper lower upper upper upper lower lower lower middle middle middle upper middle middle class
davidstanley: lower lower middle lower middle lower middle lower upper middle middle lower middle middle upper lower middle middle upper lower upper lower lower middle middle lower lower class
jeffdana: lower lower lower middle lower middle middle lower upper upper middle lower lower lower lower middle middle upper upper middle upper middle middle middle class
marybea: lower upper middle middle upper upper upper middle middle upper upper class
franzmonica: upper middle middle middle lower upper lower upper upper lower middle lower class
deannapeter: middle lower upper middle upper lower lower middle lower middle upper middle middle upper middle lower lower middle lower upper upper class
jeffkarl: upper upper lower middle lower middle lower lower middle upper upper lower middle lower upper upper upper class
josecarl: lower middle middle middle lower upper upper middle lower class
carlajohn: lower middle lower middle upper upper lower middle lower middle lower middle lower middle upper lower upper middle middle upper middle lower middle upper lower upper class
carlstan: middle upper upper lower class
patixavier: middle middle lower middle upper middle middle upper middle middle middle lower upper lower middle upper lower middle class
marianmary: middle middle lower upper upper lower middle lower lower class
edbea: upper lower lower lower middle middle lower middle lower lower lower lower middle lower middle lower lower middle upper middle upper lower upper middle class
rickpatricia: lower middle middle upper upper middle upper lower class
carlmonica: upper middle lower lower lower middle middle lower middle upper upper upper lower upper upper upper upper middle upper middle lower middle upper upper lower middle lower class
wendybea: upper upper upper lower middle middle lower middle upper lower upper lower middle lower middle middle middle middle lower middle lower class
monapati: upper upper lower middle middle middle lower upper upper upper lower lower class
garyjeff: lower lower lower upper upper upper middle lower upper lower middle lower middle lower upper lower middle class
richjack: upper upper middle lower upper lower lower lower upper upper middle middle lower lower middle class
karlmark: middle lower lower upper upper middle lower upper middle lower lower lower middle lower lower middle middle lower middle upper middle upper upper middle lower middle lower class
joseluann: middle middle middle middle upper upper lower upper upper middle upper upper lower middle middle middle lower lower middle lower lower middle middle lower class
stanmarian: upper middle upper middle upper lower lower upper upper middle middle lower lower lower upper middle upper lower class
rickbill: middle middle lower upper lower upper upper upper lower lower class
charlessue: lower middle middle middle lower lower middle upper middle upper lower class
arnolddana: lower lower upper upper middle upper middle upper middle lower upper upper upper upper lower lower lower lower upper lower class
deannaviolet: lower lower middle middle upper upper lower upper middle lower lower lower upper upper upper upper upper middle upper class
xavieranne: middle upper middle middle middle upper lower lower lower middle middle lower middle middle upper middle middle lower upper lower class
tommygary: middle upper middle upper upper upper upper upper middle upper lower lower middle lower upper middle middle upper middle lower upper lower middle middle middle middle lower class
markbea: upper upper lower middle upper lower middle middle upper middle lower lower upper upper middle lower upper upper middle upper middle lower upper upper class
williamcharles: upper middle lower lower middle middle upper lower upper upper upper lower middle upper middle middle upper lower middle lower middle upper upper upper upper class
rickmary: upper upper upper middle middle lower lower middle upper upper lower middle lower lower middle middle class
ricktom: middle middle middle lower middle middle lower middle middle middle middle middle middle upper middle lower upper upper lower lower upper middle lower upper lower middle middle class
luannsue: lower upper lower lower upper upper upper upper middle lower middle middle upper upper middle upper upper upper middle middle lower lower lower middle class
beamona: lower lower lower upper lower middle upper middle upper middle middle lower class
carlviolet: lower upper middle upper lower class
arnoldstanley: middle upper lower upper middle upper middle lower upper lower lower class
davidwilliam: upper upper lower upper upper upper middle upper lower upper middle middle upper upper middle lower upper lower lower lower middle lower lower upper middle middle upper class
jackrichard: lower upper lower middle lower upper middle lower upper lower middle upper lower lower upper lower upper upper upper middle middle lower middle upper lower class
xavierpeter: lower upper lower middle middle middle middle middle middle lower upper lower upper lower middle middle upper lower lower middle middle lower lower middle middle class
hansmarian: middle upper upper lower middle middle middle lower upper middle lower lower middle middle upper lower middle middle middle lower upper middle class
rickmonica: lower class
richardxavier: middle lower middle middle middle lower middle lower lower upper middle upper upper lower upper upper upper upper lower lower upper middle lower lower class
paticarla: middle upper upper middle class
danapatricia: middle middle middle lower upper middle lower middle upper lower middle middle lower lower middle middle lower upper middle lower upper class
rickrich: middle class
monicabob: lower upper upper lower lower upper lower middle middle lower upper middle upper upper middle lower upper lower middle lower middle lower lower lower class
stanleywendy: middle upper middle lower lower lower middle lower lower lower middle upper lower middle middle lower class
charlespeter: upper middle middle middle middle upper upper middle lower upper upper middle middle middle upper upper lower middle upper upper middle lower middle middle middle upper middle class
tombob: middle upper upper middle upper middle upper upper upper lower upper class
marianrick: upper upper middle upper upper middle upper class
luannrich: lower upper middle lower class
stanleyluann: upper upper upper lower middle upper lower upper class
hansjose: upper lower upper middle middle middle middle middle middle upper middle lower middle upper lower upper middle lower middle lower lower upper lower class
franzjohn: upper middle middle lower lower lower upper lower lower middle upper upper middle lower upper lower lower middle middle lower upper middle upper upper middle lower class
peterwilliam: lower upper lower middle middle class
josekarl: upper middle upper upper middle upper upper upper middle middle middle middle middle middle upper upper class
rickjeff: middle upper lower class
karlstan: middle middle middle middle upper lower class
monicafrank: lower upper upper upper middle upper middle lower middle upper lower upper middle lower upper middle upper lower lower upper middle upper lower class
suerichard: upper upper middle middle lower upper lower middle lower upper class
marianjack: middle upper lower middle lower upper middle upper middle lower upper upper upper middle upper middle middle lower upper upper middle middle class
danakarl: lower upper middle lower class
danaarnold: upper upper lower lower upper middle lower upper upper lower middle class
annedeanna: lower class
frankmona: upper middle middle lower upper lower upper upper middle upper upper lower lower upper middle class
edjose: upper lower middle upper upper middle upper upper upper lower middle lower middle upper middle middle lower class
patriciagary: lower lower lower lower class
xavierjeff: upper lower middle lower middle middle middle lower class
annehans: middle lower middle middle upper class
tomcharles: upper middle upper middle lower upper class
deannatom: middle upper lower middle upper middle middle upper class
standana: middle lower lower lower lower lower upper middle lower middle upper lower upper lower upper middle class
richardpati: upper upper middle lower lower lower middle upper upper upper middle upper upper middle lower lower upper upper lower upper middle lower class
frankmark: upper upper lower upper middle upper middle middle upper lower upper lower lower middle middle upper middle upper middle middle middle upper lower upper lower middle upper class
harrygary: upper lower lower upper lower lower middle middle upper lower upper lower lower upper upper upper middle upper middle upper lower upper middle lower class
richwilliam: upper lower lower upper upper lower lower lower lower lower middle class
jackviolet: upper lower middle lower middle upper upper middle middle lower middle lower upper lower lower middle middle upper lower lower lower lower middle class
richluann: middle lower class
frankjack: lower upper lower lower upper lower middle upper lower class
deannaed: upper lower lower middle middle class
suetom: upper lower middle class
peterdick: upper upper lower middle middle middle upper upper middle middle upper middle class
hansharry: lower upper middle middle middle middle lower middle class
deannadick: lower middle upper middle upper lower middle middle upper middle middle lower middle middle lower upper upper class
petercarla: upper upper class
frankdeanna: middle lower lower lower upper middle upper lower middle lower lower middle middle upper middle middle upper lower lower middle lower upper lower upper lower class
tomtommy: middle upper middle lower lower lower lower middle upper middle class
jackarnold: middle upper lower lower upper lower middle lower lower upper upper class
tommystan: middle lower middle lower lower lower upper upper lower upper upper lower upper class
karltom: lower middle lower upper upper lower upper class
harrytom: upper lower middle upper lower lower middle lower lower middle middle class
arnolddeanna: lower upper middle lower lower lower middle lower upper upper middle middle middle upper middle lower middle lower upper middle upper class
tomjose: lower upper class
tomkarl: lower middle lower upper lower upper upper lower middle middle lower middle class
davided: lower middle upper upper upper upper class
markdana: upper middle lower lower lower middle upper lower middle middle upper lower class
peterstanley: lower upper lower lower middle upper upper middle middle middle upper upper upper middle lower lower middle lower lower middle lower lower lower lower middle class
monastanley: middle upper lower lower upper upper upper upper lower lower middle upper middle upper upper upper lower lower middle upper middle lower middle class
garypatricia: lower middle upper middle upper middle lower lower middle lower middle upper middle lower middle lower lower middle upper upper lower middle lower middle upper lower class
standick: upper upper upper upper middle upper upper upper middle lower upper middle lower lower class
edrick: middle lower upper middle class
anneluann: middle lower lower upper middle middle lower upper middle upper upper middle upper middle middle upper middle upper upper upper middle upper upper upper lower class
patriciatom: upper lower upper lower lower lower lower middle lower middle lower middle lower upper middle middle lower middle middle middle middle upper class
charlesdavid: upper middle lower lower middle middle lower upper middle middle middle upper middle middle upper class
tomwendy: middle middle upper lower lower middle lower middle upper upper middle lower lower lower middle upper middle lower lower upper lower middle class
williamrick: upper lower lower upper middle upper middle upper middle upper middle middle lower lower middle lower lower lower upper middle middle lower middle lower middle upper lower class
tommywilliam: upper upper lower upper lower middle lower upper upper upper lower lower lower lower lower lower middle lower class
hanspatricia: lower lower class
patriciamarian: middle upper middle upper middle upper middle upper middle lower upper middle lower lower lower lower upper lower upper lower upper class
frankxavier: middle middle middle lower lower lower lower middle upper lower upper upper upper middle upper upper lower lower lower class
tommykarl: middle upper upper middle lower middle lower lower middle lower upper lower lower middle lower lower middle middle middle upper class
arnoldgary: upper lower upper middle upper lower lower upper lower upper lower middle upper middle middle upper lower middle upper middle upper middle lower class
xaviered: lower upper middle middle upper upper middle upper middle middle upper upper class
marianwendy: lower upper upper upper middle lower upper middle lower middle middle middle middle lower lower class
franzxavier: upper upper upper middle middle middle class
jackjack: middle lower upper middle upper upper upper upper lower middle upper upper lower lower upper upper middle lower lower middle class
edrichard: lower class
danadavid: upper upper lower middle upper upper upper upper lower upper lower upper lower lower upper upper class
billmarian: middle lower upper upper upper upper upper middle lower upper upper lower middle upper lower upper lower lower lower lower class
markcarl: middle lower lower upper middle upper middle middle lower middle lower upper middle class
richardharry: lower middle lower lower upper lower upper lower middle middle upper lower upper middle middle lower middle class
rickfrank: middle middle middle upper upper class
stanleyfrank: lower class
marianviolet: upper middle lower upper upper upper lower lower lower upper lower middle middle middle middle middle middle upper upper lower upper upper middle upper lower lower lower class
dickhans: upper class
bobwilliam: upper middle lower lower middle lower lower middle lower lower middle middle upper upper middle middle lower upper lower upper upper class
tommytom: upper lower middle middle middle upper middle upper class
jeffjohn: middle upper lower upper upper middle upper lower lower lower upper lower lower upper middle lower lower upper upper middle upper lower lower upper lower upper lower class
stanviolet: lower upper class
beastan: upper upper upper upper middle middle upper lower lower upper lower lower upper lower middle upper lower upper lower upper upper middle middle class
hanswendy: upper middle upper upper lower upper upper lower middle middle lower middle lower upper middle upper middle class
danastanley: lower middle lower lower lower middle middle lower middle lower middle middle lower middle middle middle lower upper upper lower lower middle upper middle lower middle class
williamhans: lower upper middle lower upper middle upper lower middle middle lower lower middle upper upper upper middle lower class
dickbea: lower lower lower lower upper middle middle upper middle lower lower upper upper upper upper upper class
karlxavier: upper middle lower middle upper middle upper middle upper upper middle class
dickpatricia: lower upper lower middle lower middle upper lower upper lower middle lower middle middle upper middle middle upper middle upper middle middle upper lower lower class
jeffstan: upper lower middle middle middle lower lower upper class
beapatricia: upper middle lower upper upper upper upper middle upper upper upper lower lower middle middle lower lower lower middle upper lower lower lower lower upper upper class
luannbill: upper upper middle upper lower upper lower upper upper lower lower middle upper lower upper lower lower upper upper lower upper class
stanleydavid: middle lower middle middle upper middle middle middle upper middle upper middle upper lower lower lower middle middle middle class
frankmarian: upper middle middle lower middle lower middle middle lower middle lower upper upper lower class
rickcharles: middle class
suejeff: middle lower upper middle middle lower lower lower lower upper lower class
franktommy: lower middle upper middle upper lower upper upper lower middle lower lower class
rickfranz: lower upper lower lower middle lower lower upper upper class
