1000
richardwendy: lower middle middle middle middle upper upper upper upper upper middle middle middle upper middle lower middle middle lower upper middle lower lower class
jeffpati: middle lower lower middle upper middle upper lower middle lower middle upper lower middle upper lower upper lower class
richluann: upper lower lower middle upper middle upper middle upper upper lower upper lower lower upper upper class
karlcharles: lower upper middle middle middle lower middle lower middle lower upper middle middle middle upper lower upper lower class
frankluann: upper lower middle middle lower upper lower class
deannabob: upper middle lower lower class
karlfrank: middle middle upper lower upper upper upper upper upper middle upper middle upper middle upper upper class
davidcharles: upper upper lower upper middle upper middle lower upper middle lower middle lower upper lower lower upper lower middle middle middle lower middle class
patriciacharles: upper middle lower upper lower class
richardstan: lower middle upper middle lower lower upper middle middle lower upper middle middle upper lower upper class
deannabea: lower middle class
charlesjeff: lower lower lower lower upper upper lower upper lower upper middle middle upper upper upper middle middle upper lower class
suejack: middle middle middle class
arnoldluann: lower upper middle upper upper middle upper middle class
monastan: middle middle middle middle upper lower upper lower middle upper class
monaarnold: middle class
monapeter: upper middle lower lower lower lower middle middle upper lower upper upper middle middle lower upper lower middle lower middle upper lower upper lower middle lower lower class
carlmary: upper upper lower upper middle lower lower lower lower lower middle middle upper lower middle lower lower lower middle middle lower middle lower middle class
edpati: upper upper middle upper upper upper middle lower lower middle lower lower middle lower lower lower middle middle lower upper upper class
franzkarl: middle upper lower middle lower upper lower lower lower upper upper upper lower upper middle class
billmarian: upper lower lower lower lower middle upper lower upper lower lower middle lower upper upper middle upper upper upper upper middle upper lower middle middle lower class
peterharry: lower upper lower upper upper lower lower lower middle upper class
carlaluann: upper lower lower lower lower upper lower upper lower middle upper upper lower lower lower lower middle middle middle upper class
suejohn: middle upper upper middle lower upper lower lower middle middle class
charleswilliam: middle lower middle lower middle middle middle upper middle middle middle lower upper middle upper lower upper upper class
arnolddavid: upper upper upper upper lower lower middle middle middle lower middle upper upper upper upper middle lower upper class
danafrank: middle middle upper upper upper middle lower upper upper upper middle upper middle middle lower upper upper middle lower upper lower middle upper upper upper class
rickstanley: lower middle lower lower upper middle middle class
monawendy: upper upper lower lower class
charlesdana: upper lower upper upper lower upper class
tommydavid: upper lower lower upper middle lower lower upper upper upper middle upper upper lower lower class
williammonica: lower upper middle lower upper upper upper middle middle lower lower middle lower middle lower upper middle middle middle lower class
marianbill: lower middle lower lower middle middle middle lower upper lower middle middle middle middle lower middle middle upper lower upper lower lower class
patitom: upper lower upper middle lower middle class
marianrichard: middle middle middle upper upper upper upper middle upper lower middle middle middle lower upper middle middle upper middle class
patricialuann: lower lower lower upper upper upper upper middle lower lower upper middle lower upper lower lower upper middle lower lower lower lower lower class
frankbob: middle lower upper lower middle upper lower upper upper middle lower lower class
richardhans: lower middle upper upper lower middle lower upper upper lower lower lower upper lower middle upper middle upper upper lower lower lower middle class
patriciatommy: lower upper lower middle lower upper upper upper upper lower middle middle upper middle upper middle upper lower lower upper lower middle class
carlarnold: lower lower lower middle lower middle lower middle middle middle upper middle class
williammary: middle upper middle lower lower lower middle lower middle middle middle middle upper upper upper upper middle middle middle lower upper lower lower lower lower middle class
jackarnold: lower lower upper upper upper upper middle lower lower lower lower middle lower upper upper middle upper upper lower upper middle middle upper middle class
charleskarl: lower upper lower middle middle middle lower middle lower lower lower lower middle middle middle upper middle upper lower lower upper upper upper middle lower middle upper class
violetgary: lower class
arnoldbob: lower middle middle upper middle middle lower upper lower middle upper middle class
edxavier: lower middle class
johnstanley: middle lower middle upper middle middle upper middle middle middle lower lower class
josebob: upper lower class
deannastanley: middle lower middle class
davidmarian: middle middle upper class
patimark: lower middle middle lower middle upper lower middle lower middle middle middle lower lower middle upper upper upper upper lower class
arnoldcharles: lower lower upper middle upper middle upper lower middle lower upper middle upper middle upper upper upper middle middle upper middle middle upper middle class
markbill: middle lower class
richviolet: lower upper class
williambea: lower upper middle upper middle lower lower upper lower class
danamona: middle middle upper lower lower lower upper class
arnoldstanley: middle middle lower lower lower middle upper lower lower lower upper middle lower middle lower upper upper middle middle lower lower upper class
carlawendy: middle upper upper middle middle lower upper middle lower middle upper lower lower upper upper class
xavierkarl: lower class
tommybea: lower lower lower middle middle middle lower upper middle upper lower middle middle class
johnharry: upper upper lower upper upper upper lower lower lower upper upper lower upper upper upper upper middle upper upper upper class
beafranz: upper lower upper lower lower lower class
maryxavier: middle middle middle upper upper upper class
franzed: middle middle upper lower upper middle lower middle lower upper lower class
patied: upper lower middle middle lower lower middle lower lower middle upper lower upper lower upper middle upper upper upper upper middle middle middle class
hanspatricia: lower lower lower middle middle middle lower upper upper middle upper middle lower middle upper lower middle upper upper upper lower upper class
stanleybob: upper lower upper lower lower upper upper upper lower middle lower lower lower middle middle class
frankfrank: upper lower middle lower lower lower lower middle upper upper lower upper upper upper middle lower middle lower lower upper upper upper upper lower upper middle middle class
garygary: upper lower middle lower middle lower upper class
stanleypatricia: middle lower lower upper lower middle lower middle lower upper lower middle middle upper lower middle middle upper upper upper upper upper upper class
bobpatricia: middle middle middle lower lower upper lower upper upper lower lower lower upper middle lower upper upper upper lower upper lower lower class
rickfranz: middle upper upper lower lower middle upper middle upper lower upper upper middle middle middle middle middle lower middle upper lower middle upper middle lower class
monicatommy: lower class
xaviermary: upper middle middle lower lower middle lower lower upper lower middle middle upper lower upper upper middle upper middle upper upper middle lower middle middle class
richbea: middle upper middle lower middle lower lower upper middle lower upper upper lower lower lower lower class
dickanne: upper upper upper upper upper upper upper upper upper upper middle middle class
dickdick: upper lower middle upper lower middle lower upper upper middle lower middle upper lower middle middle class
danacarla: upper lower upper middle lower middle upper lower class
frankrich: middle lower upper lower middle middle lower lower upper lower middle lower upper middle lower class
harrywilliam: middle lower upper upper upper lower lower lower middle class
karlmark: lower upper lower lower upper lower lower middle middle middle upper lower upper middle upper upper middle middle middle upper middle class
garyluann: lower lower middle middle lower upper lower lower upper lower lower upper lower upper upper upper upper middle lower lower class
hanscarla: middle middle upper upper middle middle lower upper middle middle middle middle lower upper upper upper upper lower upper upper upper upper upper lower middle class
peterbill: upper lower lower middle lower lower lower middle lower middle upper lower middle upper lower lower lower upper middle lower class
jeffbill: upper middle upper upper lower upper middle upper middle class
richrich: lower middle lower upper lower lower lower lower middle lower lower upper middle middle lower middle upper lower middle lower middle upper upper class
carlstan: upper class
tomxavier: middle middle middle middle lower lower upper middle middle upper middle lower middle upper upper lower lower lower middle class
monicatom: upper lower middle upper upper middle middle middle lower upper lower lower lower lower middle class
luannjack: lower middle lower upper middle upper middle middle lower lower lower middle lower lower upper middle middle lower lower middle lower middle middle class
stanleywilliam: middle upper upper upper upper upper upper middle lower middle middle lower lower upper upper lower middle upper upper class
markrick: middle middle lower upper lower middle upper lower upper upper middle upper middle lower upper upper middle class
stanleybea: lower middle middle lower upper middle upper middle upper middle class
franzmark: upper upper upper middle middle lower upper middle upper lower lower class
peterdick: upper middle upper middle middle lower lower lower lower upper class
deannamonica: lower lower middle lower lower class
billmona: lower upper middle upper upper middle upper middle class
markdick: upper upper middle upper upper middle upper middle class
jackmarian: middle upper class
xavierrick: middle class
williamluann: upper middle upper lower lower middle middle upper upper upper middle lower middle middle middle middle middle upper lower middle middle upper upper upper lower middle class
annepati: middle lower upper upper lower upper lower middle lower lower middle class
franzcarla: lower upper class
harryfrank: lower lower middle lower lower lower middle lower upper middle lower lower lower upper middle lower lower class
garyjeff: upper upper upper middle upper lower upper upper upper middle lower upper upper upper upper lower upper upper lower upper middle lower upper middle class
peterdeanna: upper upper middle middle upper lower lower lower upper lower upper middle lower middle class
davidbob: lower middle middle upper middle lower upper lower lower upper middle middle middle lower middle class
tommyjack: lower middle upper middle middle lower middle middle upper middle middle middle middle lower lower upper middle middle lower lower middle middle lower class
xavierdeanna: upper upper middle lower upper upper class
wendyjose: lower lower upper upper lower lower upper upper middle class
jeffrich: lower lower lower upper middle lower lower upper middle middle middle middle middle upper middle lower middle lower upper middle lower middle lower class
rickmark: middle lower middle upper upper middle upper lower middle middle lower middle middle lower middle upper lower upper middle lower upper middle middle class
stangary: upper middle lower upper upper lower middle upper upper upper lower upper upper upper lower lower lower upper upper upper lower lower middle lower middle class
peterstanley: lower upper lower upper middle lower lower upper upper upper upper upper middle upper upper middle upper upper middle lower middle upper upper middle class
dickjack: middle middle lower middle upper lower middle upper middle upper lower middle lower middle lower middle lower middle upper middle upper upper lower lower class
tommystanley: middle middle lower lower middle upper lower lower lower upper lower upper upper upper lower upper upper lower middle lower middle lower lower class
harryviolet: lower middle middle middle lower middle middle lower upper lower middle lower middle lower lower middle lower class
beamona: middle lower middle lower upper upper middle upper upper lower lower middle upper upper lower class
marianluann: middle upper upper lower class
arnoldbea: upper lower lower upper upper lower class
karlrick: middle upper middle middle upper upper middle lower middle upper lower upper upper middle lower lower lower middle lower upper lower upper upper middle middle class
jackwendy: middle upper middle class
bobtom: upper lower middle upper lower lower middle middle upper lower upper upper middle lower lower middle lower middle lower lower lower middle lower middle class
tomcarla: middle lower lower upper lower lower upper upper middle class
stanleyjose: lower lower lower upper middle middle class
monicamonica: upper middle upper lower upper lower lower upper lower middle lower upper lower upper lower upper lower middle lower upper lower class
rickmonica: upper middle upper lower upper class
johnrichard: middle upper middle middle upper middle lower middle lower middle middle class
carlamonica: lower lower middle middle middle lower lower upper upper lower lower upper upper lower middle upper upper upper middle upper lower upper upper upper middle lower lower class
xavierfrank: middle middle upper middle middle middle lower upper upper middle upper upper upper lower upper middle middle upper middle class
williambill: upper middle class
stanpati: middle upper lower class
edbill: upper middle lower middle middle lower lower middle upper lower middle lower upper upper lower upper lower middle upper lower middle class
patriciamonica: lower class
annepeter: lower middle upper middle middle lower middle upper lower lower upper middle lower lower middle lower middle upper middle class
annemary: upper middle upper middle class
billpatricia: upper class
johnmarian: lower middle lower upper upper middle upper middle upper lower middle middle class
sueluann: middle lower upper lower middle middle lower lower middle upper upper lower lower middle middle middle middle middle upper middle middle lower middle middle class
patigary: lower lower upper lower lower middle upper lower upper upper upper lower middle lower lower middle upper upper upper middle lower lower middle lower lower class
hansbob: middle middle middle middle lower lower lower lower class
patriciagary: upper class
williamsue: upper middle middle lower upper middle upper upper upper middle middle upper lower lower middle lower lower middle middle middle middle lower middle upper lower middle class
rickcarl: upper lower upper class
billdana: lower upper upper upper middle lower upper middle upper lower lower lower middle middle lower middle middle middle lower class
wendycarl: middle middle lower upper lower lower middle middle upper upper lower middle lower class
carlaviolet: lower middle upper lower lower upper upper middle lower lower class
jeffdick: upper upper upper upper upper lower upper upper middle middle upper lower lower upper middle lower lower middle middle lower lower upper upper middle middle lower class
tommark: upper lower lower middle upper middle lower middle lower lower middle lower middle lower lower upper upper lower class
johnwendy: lower middle lower upper upper lower upper lower class
charlescharles: lower lower lower middle lower middle upper class
stanleyarnold: upper middle class
beaanne: middle upper middle class
johnpati: middle upper middle middle upper upper middle middle lower upper lower upper upper middle upper upper middle upper lower lower upper upper class
violetmona: lower upper lower middle lower upper upper lower upper upper upper class
richmona: lower lower lower middle middle lower lower class
carlaanne: middle middle lower middle lower lower middle middle middle lower class
billmary: lower upper lower middle upper middle middle upper lower upper middle lower lower middle middle middle lower upper middle middle lower middle lower upper upper middle lower class
tommygary: lower class
carlacarla: lower upper upper lower middle lower upper lower lower lower upper middle middle upper upper class
edjack: upper upper lower middle middle upper lower lower upper upper upper upper lower upper middle upper lower lower middle lower upper middle lower lower class
carlatommy: middle upper upper upper upper middle lower upper upper lower middle lower upper lower lower middle lower middle class
frankmonica: upper upper lower upper lower middle upper lower upper lower lower middle lower class
tommycarl: middle upper middle upper lower lower lower middle upper upper middle lower middle upper middle upper upper upper upper upper lower upper lower class
marktom: lower lower middle middle upper upper upper middle upper lower lower lower upper class
deannadana: middle lower upper lower upper lower middle middle middle middle upper middle lower middle lower lower upper middle middle lower lower class
patixavier: upper upper lower upper upper middle upper class
davidstan: upper middle upper upper upper upper upper middle middle middle lower middle upper upper class
beasue: middle lower lower middle lower lower upper upper lower middle lower middle lower middle middle class
arnoldmary: upper middle lower upper lower upper upper middle middle middle lower middle lower lower middle upper class
marywilliam: upper upper lower lower class
rickrich: lower lower middle lower upper upper lower upper upper class
beabea: middle upper middle lower middle upper upper middle lower middle upper upper middle upper lower lower class
carlviolet: upper upper middle middle upper upper lower middle middle upper lower upper lower lower middle upper upper upper middle middle upper upper upper middle middle class
wendyjeff: lower lower upper middle upper upper lower upper lower middle lower lower upper upper upper middle lower upper class
karltom: middle upper lower upper middle upper lower upper lower upper lower middle middle upper upper lower middle lower class
bobsue: upper middle lower lower upper lower lower lower middle lower class
markwendy: lower middle lower lower lower middle middle lower upper upper middle class
jacksue: lower middle class
harrytommy: upper middle upper upper middle middle lower lower middle upper middle lower middle class
anneluann: middle upper upper upper middle middle lower lower middle middle middle middle lower lower upper upper middle upper upper middle class
monagary: lower lower middle middle upper middle lower middle upper lower class
anneanne: upper upper middle lower middle middle middle upper upper lower upper middle middle middle middle lower upper middle class
rickgary: upper lower middle upper upper lower lower upper lower lower lower upper lower middle lower lower lower middle lower lower middle middle lower middle middle lower class
marktommy: middle upper lower lower middle middle upper upper upper upper middle lower lower upper middle class
patijohn: upper lower lower middle lower upper lower upper lower middle upper lower middle middle class
carlbill: lower upper upper lower middle lower middle upper middle class
carlrick: lower middle lower lower upper lower upper lower upper middle upper middle lower upper lower lower upper upper lower middle upper class
billjohn: lower upper lower upper middle upper lower middle lower lower upper lower middle class
karled: middle upper lower lower upper upper upper upper upper upper lower middle upper lower upper lower lower middle upper middle middle middle upper class
johnkarl: lower upper middle upper middle middle lower upper lower upper lower middle middle lower middle lower upper class
luannviolet: lower lower upper upper lower lower lower lower lower upper lower middle lower class
stanleybill: middle lower upper middle lower upper upper middle upper middle lower lower upper upper lower middle middle lower lower lower class
charlesjohn: upper lower upper middle lower upper middle middle upper lower middle lower lower upper class
frankrick: upper middle lower upper lower lower middle middle middle lower middle upper lower lower lower middle middle middle lower lower upper lower class
frankfranz: lower upper class
carlcarl: upper middle lower upper class
wendydavid: middle lower middle upper upper upper lower middle upper lower middle lower upper upper middle upper upper upper middle middle lower upper lower middle upper upper lower class
patideanna: lower upper lower upper middle lower middle lower lower lower upper lower upper middle middle lower middle upper lower lower class
stanleymona: middle lower upper upper middle upper lower lower lower upper middle middle middle middle lower lower lower middle class
joseharry: middle upper lower upper lower lower middle lower middle middle lower lower lower upper class
jeffgary: lower lower upper middle upper upper upper upper upper lower middle middle lower upper middle upper middle upper middle lower upper class
carlawilliam: lower upper lower upper upper lower lower lower middle middle middle upper lower upper upper lower upper upper upper upper upper middle upper lower class
bobmarian: middle middle class
tomjohn: upper upper lower class
franzrick: middle upper lower lower lower lower upper lower upper lower lower class
richsue: middle upper lower lower lower lower class
bobarnold: middle upper lower upper middle middle upper middle upper class
jeffbob: middle lower upper lower upper middle upper class
franzjohn: middle upper upper lower middle middle upper middle lower lower upper middle middle lower upper lower middle upper middle lower lower middle lower middle middle class
marianhans: lower lower middle lower upper middle lower upper middle middle middle middle middle lower middle upper lower lower upper upper upper class
bobpati: lower upper upper lower middle lower lower lower upper middle middle lower middle upper upper upper middle middle upper middle middle lower class
davidmonica: middle lower lower lower lower upper upper upper upper lower upper lower upper middle upper upper middle lower lower middle lower lower upper class
rickdeanna: lower lower lower upper lower lower middle lower middle middle lower upper upper upper upper middle upper upper class
arnolddana: middle lower middle lower middle middle lower lower upper upper upper upper class
billfranz: lower upper upper middle middle upper middle middle middle lower middle lower class
edmona: middle lower upper class
harrytom: lower middle middle upper middle middle middle upper middle lower middle upper upper middle lower middle lower middle upper upper class
garycarl: lower middle lower middle upper lower middle lower middle class
monacharles: upper middle middle upper upper upper upper middle lower middle lower upper middle lower middle upper lower upper upper lower middle lower middle upper class
arnoldstan: upper upper upper middle upper upper middle lower lower lower middle upper upper middle upper upper upper upper lower class
carlasue: middle upper middle upper upper middle lower class
frankarnold: middle upper lower lower class
dickmary: lower lower middle lower upper lower lower lower lower upper lower middle upper lower upper upper middle lower lower middle lower middle lower class
beaed: upper lower middle upper upper middle class
beadana: lower upper middle upper lower lower middle class
davidcarl: lower middle lower lower middle lower lower upper middle upper middle upper lower middle upper middle upper middle lower upper class
karlmarian: upper middle lower upper upper lower upper lower lower middle middle lower upper middle lower upper middle lower upper class
hansdavid: upper upper lower upper lower lower middle upper class
jackbill: upper middle lower middle upper middle upper middle upper upper upper middle upper middle middle lower upper middle upper middle upper upper upper lower middle class
danadeanna: upper middle upper middle upper middle upper upper middle middle upper upper lower lower middle lower upper lower middle middle class
wendygary: lower middle upper middle middle middle lower upper upper upper middle middle upper middle lower lower upper lower lower lower upper lower upper middle upper lower class
beadick: lower middle upper upper middle middle upper middle middle middle middle middle middle middle lower lower class
carlmona: upper lower middle upper middle middle middle middle lower lower lower lower middle upper middle class
marianfrank: middle upper middle lower middle middle middle upper middle upper class
monajohn: middle middle lower lower lower upper lower lower lower lower upper middle middle lower lower upper lower middle upper middle upper class
richarddeanna: middle upper upper upper lower lower lower upper lower class
williampati: upper upper middle upper lower lower upper upper upper middle upper upper middle lower class
harrymona: upper middle lower upper upper upper upper middle middle middle middle upper lower lower upper lower middle class
marywendy: upper lower middle lower lower lower upper middle lower upper middle middle class
arnoldmarian: upper middle upper middle middle lower class
joseanne: upper upper middle upper lower upper lower upper upper lower lower middle upper lower lower upper middle middle upper lower upper middle upper upper middle upper upper class
stanpatricia: lower upper upper lower middle middle middle lower upper upper upper middle upper lower middle class
carlmarian: lower middle upper class
tommydick: upper lower upper lower middle middle middle middle middle upper upper upper lower lower upper lower upper lower upper lower middle class
wendyluann: upper upper lower upper upper middle middle middle upper upper upper lower middle lower lower upper upper middle middle middle upper middle upper upper lower upper class
williamjeff: lower upper middle upper lower upper lower lower lower lower lower upper upper lower upper lower middle class
josejack: lower lower upper upper lower lower lower lower upper lower upper lower lower middle upper lower upper upper upper class
joserick: middle upper upper lower upper lower upper upper lower upper lower lower middle lower class
jackhans: lower upper middle middle upper upper upper lower middle middle middle lower middle upper middle middle upper middle lower upper middle middle upper middle upper middle class
billxavier: lower upper upper middle upper upper upper upper lower upper middle lower lower upper lower upper lower upper lower class
violettommy: lower middle lower lower middle lower middle lower lower upper lower class
violetwendy: middle lower lower lower lower middle upper middle lower upper lower middle middle upper class
jackbob: lower middle middle upper lower middle upper upper lower upper lower upper upper lower middle middle upper lower middle middle lower lower lower lower lower upper class
billmonica: lower middle middle middle middle middle upper upper lower lower lower middle upper lower lower middle lower class
bobjose: lower upper upper upper lower middle lower middle lower upper upper class
rickjeff: middle middle lower upper upper middle upper lower lower upper upper middle upper middle middle middle middle upper lower lower class
xavierstan: upper middle lower class
carljohn: upper lower lower upper middle class
davidluann: lower lower middle upper upper class
garydeanna: middle upper middle middle middle class
frankwendy: upper upper middle lower middle lower class
franzcharles: upper lower middle upper upper class
danatommy: lower lower upper lower middle lower upper lower middle lower middle lower lower middle lower class
hansjeff: middle lower upper middle middle lower middle upper middle lower lower lower lower middle upper middle middle upper lower lower middle upper upper middle lower middle class
carldana: upper upper lower lower upper middle upper upper middle upper lower middle upper lower lower class
richardkarl: middle middle middle middle middle upper upper middle middle middle lower middle upper lower lower lower middle middle upper class
xavierjohn: lower upper upper middle upper middle middle lower upper upper class
petertom: lower upper middle middle middle upper upper middle upper upper upper upper lower upper upper lower upper middle middle lower middle lower class
monicajohn: lower middle lower lower middle upper upper middle middle upper class
stanleymarian: upper lower middle middle middle upper lower lower upper upper lower upper lower middle upper upper lower middle middle middle upper lower middle lower middle lower class
wendyrich: lower middle lower middle middle class
richardjohn: middle upper middle upper middle upper class
stantommy: upper lower upper middle upper middle middle upper middle middle lower middle middle lower upper upper upper class
jeffxavier: middle upper lower upper middle lower middle middle upper middle middle middle upper middle upper lower class
tomgary: lower upper lower lower upper lower middle lower upper middle middle middle middle upper middle upper lower lower class
richardcharles: lower lower middle upper middle lower upper upper lower lower middle lower upper lower class
tommyharry: lower middle upper lower upper middle upper upper upper middle class
charlestommy: middle lower lower middle upper middle upper middle middle middle middle lower upper class
karlwilliam: upper middle class
garyhans: lower lower lower upper middle middle middle lower upper upper upper class
carlapati: upper lower lower upper middle lower lower upper middle lower lower middle class
bobdana: lower lower upper lower middle upper class
violetfrank: lower middle upper class
davidwilliam: lower lower middle upper lower upper middle upper middle upper middle lower lower middle upper class
richcarl: upper lower middle middle upper lower upper upper class
frankjack: upper upper middle lower upper middle lower upper upper upper middle middle middle upper lower middle upper upper upper lower lower upper middle lower lower upper class
mariankarl: upper lower lower lower upper lower middle upper class
williambob: upper upper middle lower lower upper upper lower middle lower upper upper middle lower upper middle middle upper lower lower middle lower lower lower upper class
patriciaharry: lower lower upper upper class
franzluann: lower class
johnbob: upper upper upper middle upper lower middle upper lower upper middle class
monaviolet: middle upper upper lower middle upper lower middle upper upper upper upper lower middle class
maryanne: lower lower lower upper middle upper upper upper middle middle lower lower upper lower middle upper middle middle class
tomluann: lower upper upper upper middle lower lower lower middle lower middle upper upper upper upper lower middle lower upper lower middle lower class
richardbea: lower middle upper lower middle lower middle lower lower upper lower upper middle class
suestanley: lower lower upper upper lower upper middle class
richdick: lower lower upper lower middle upper middle upper lower middle upper middle lower class
marianmonica: middle lower lower upper lower middle middle upper upper upper middle middle upper lower lower class
patriciabob: lower lower middle upper lower upper upper lower upper upper class
patiluann: lower upper lower upper upper middle middle lower middle middle lower upper middle lower lower lower middle lower class
mariantom: lower lower lower lower upper middle middle upper lower upper lower upper upper upper middle lower upper lower class
stanjohn: upper lower lower lower lower upper upper upper middle middle middle middle lower upper lower lower middle lower upper lower upper upper upper class
frankbea: middle upper lower middle lower middle middle upper middle class
karljose: upper upper middle lower lower lower upper middle class
edgary: lower upper lower upper lower lower lower middle lower middle upper lower middle class
stanleyviolet: upper lower upper class
beawendy: upper lower lower upper lower class
monicawendy: middle upper upper middle middle middle upper lower lower lower middle middle lower lower middle lower lower lower middle lower lower middle upper class
edcarl: upper middle upper lower lower lower middle upper middle class
hansrick: upper upper lower upper lower upper lower middle lower class
patriciafranz: middle middle middle upper upper middle lower class
patriciamona: upper middle middle lower middle upper middle middle lower lower upper upper upper lower lower middle upper middle upper upper middle upper middle lower lower middle class
richdavid: upper class
mariandavid: upper upper upper upper upper upper upper middle middle lower upper upper upper lower middle middle lower middle middle upper upper lower class
violetkarl: upper upper upper middle middle middle upper middle lower middle lower class
carlamark: middle upper upper upper lower upper upper lower upper middle upper middle lower lower lower middle upper middle upper upper middle class
williamcarl: upper middle upper middle lower upper middle middle upper middle middle upper middle lower middle class
ricksue: middle upper class
richardcarla: lower lower upper upper middle upper middle upper upper middle lower lower lower upper upper middle class
jackkarl: lower upper upper upper lower middle lower upper middle lower lower lower upper lower upper upper upper lower middle class
johnwilliam: upper middle middle middle middle upper middle upper lower middle middle class
hanskarl: middle middle middle lower lower upper lower lower lower lower lower class
violetwilliam: lower lower lower middle upper lower middle lower upper middle lower upper lower middle lower middle upper class
charlesjose: middle lower middle middle lower upper middle lower lower upper upper middle middle middle lower upper class
carlmonica: middle middle middle lower middle upper upper middle lower middle upper lower lower lower upper lower upper upper middle upper class
jeffarnold: lower middle middle upper middle upper middle upper upper upper middle lower middle middle middle upper lower lower upper class
frankbill: middle upper lower lower middle middle lower lower lower lower middle lower lower lower middle middle middle upper middle class
patiwendy: lower lower middle upper upper class
annedeanna: middle lower lower upper upper middle middle middle lower lower upper class
suedavid: middle middle middle upper upper middle lower upper lower upper lower upper middle upper lower middle lower class
stanjeff: lower lower class
jacktommy: middle upper lower class
billrick: lower lower middle lower lower upper lower upper upper middle upper lower middle upper middle class
stanleydick: middle lower middle middle lower upper middle lower class
jefftom: lower middle upper upper lower middle lower lower middle lower upper lower lower middle upper middle lower upper middle upper upper lower middle middle class
jeffviolet: lower upper middle lower middle lower upper middle middle upper lower lower lower lower upper lower lower upper upper middle middle upper upper middle upper upper middle class
patitommy: lower middle middle upper middle class
carljeff: lower lower class
dickmonica: lower upper lower lower middle lower lower middle middle class
charlessue: upper middle middle middle middle upper middle lower lower middle upper upper middle lower middle upper middle upper lower class
karlstanley: upper middle upper lower upper upper middle upper middle class
dickmarian: upper lower middle middle upper middle lower middle middle lower middle lower middle upper middle lower upper middle lower lower lower upper middle upper lower lower upper class
peterwendy: lower class
rickluann: middle middle middle lower middle upper upper upper lower lower lower lower lower middle middle upper lower middle middle middle lower class
suemark: middle upper lower middle middle upper upper upper lower lower upper upper upper class
stanwendy: lower middle class
marystan: lower middle middle lower upper upper middle upper lower lower lower lower lower middle upper lower lower lower lower class
hansarnold: middle upper middle lower class
beamonica: lower upper lower lower lower lower upper upper middle upper upper class
patipeter: upper upper upper lower lower lower upper upper middle middle upper middle middle class
annejeff: upper lower lower upper lower middle middle lower middle upper middle lower upper lower upper lower upper middle lower middle middle lower class
franzanne: lower upper middle lower middle upper middle upper lower upper middle lower upper class
edrich: upper lower lower upper middle lower lower middle lower middle middle lower class
charlesdeanna: upper upper class
richardjack: upper upper middle upper lower upper upper lower upper upper lower lower middle middle middle lower lower middle class
tomarnold: middle lower lower middle middle middle middle middle lower upper middle lower lower middle middle upper upper lower upper upper class
carldeanna: upper lower upper upper lower lower lower upper upper middle middle lower middle middle lower lower lower upper lower class
jeffmonica: upper lower upper lower middle upper middle lower upper middle upper middle lower middle lower lower middle lower middle upper class
karlpati: middle upper middle middle middle middle lower middle middle upper upper lower lower upper lower upper middle lower upper class
carlarichard: lower middle lower upper middle lower class
bobgary: middle middle middle lower middle upper lower upper lower upper middle middle middle lower upper upper upper lower class
rickdavid: upper upper lower upper middle lower lower lower lower upper lower upper upper class
monicastan: middle middle upper middle middle lower lower middle lower lower lower lower lower class
monamary: middle middle upper lower middle lower middle lower middle upper lower upper upper class
richardluann: lower lower upper lower upper middle class
williamkarl: lower lower lower lower class
rickwilliam: middle upper upper middle class
deannaluann: lower lower lower middle middle lower upper lower lower lower lower lower lower upper lower class
xavierxavier: middle upper upper upper middle lower lower middle lower upper class
jackxavier: upper lower middle class
monicadeanna: middle middle lower upper lower middle upper lower upper upper upper lower lower lower lower lower upper upper middle upper upper lower middle lower lower class
carlcarla: lower lower lower upper lower lower middle upper middle upper lower upper lower lower upper lower class
luannluann: lower middle lower middle upper lower middle middle middle lower middle middle middle class
patriciaxavier: middle upper middle upper upper class
billtommy: lower lower lower middle lower lower class
carlajose: lower lower middle upper middle upper middle lower lower lower upper lower middle lower lower class
johndavid: middle middle middle lower lower upper lower upper lower lower middle middle upper upper upper middle lower lower middle upper upper middle lower lower class
monicarick: upper upper upper lower upper upper class
jeffsue: upper lower upper upper middle upper middle lower middle upper lower lower lower class
hanscarl: middle middle upper upper middle upper upper class
rickbea: middle middle upper upper middle upper lower middle lower middle middle lower lower upper upper lower class
williamviolet: upper middle upper lower lower middle middle lower lower middle middle lower upper middle middle middle lower upper lower lower upper upper lower middle middle upper class
garywilliam: lower middle lower middle middle middle lower lower upper upper middle upper middle upper upper upper upper class
tomtommy: lower upper lower lower upper middle middle middle upper lower lower class
carladick: upper upper middle middle lower middle lower lower middle upper middle upper lower class
peterpeter: lower lower middle lower middle lower lower upper middle lower lower class
danabea: middle lower middle middle class
davidkarl: middle middle lower upper middle upper middle class
paticarla: upper lower class
stanleysue: lower middle lower lower upper upper upper upper middle upper upper lower lower lower class
harrymarian: upper middle upper upper upper upper upper middle middle lower class
josebea: middle lower lower middle lower upper upper lower middle middle middle upper lower middle lower lower middle upper middle middle lower middle middle class
garydana: middle middle upper middle lower middle lower lower middle upper lower class
ricktom: lower upper middle middle lower upper lower middle lower lower middle upper upper lower middle lower upper lower class
garyed: middle lower middle class
violetcarl: lower lower middle upper class
danadavid: upper lower lower lower upper middle middle middle middle upper upper middle upper lower middle middle upper lower middle lower middle lower upper upper lower class
marianharry: lower lower upper middle lower middle upper lower lower class
patriciacarl: lower middle upper upper lower middle lower class
peterluann: upper upper middle lower lower middle middle upper upper middle upper middle upper middle lower middle upper upper lower lower lower upper lower middle class
johnjohn: middle middle upper upper middle lower upper upper upper lower middle lower upper middle upper middle class
marytom: upper middle upper upper upper middle upper lower upper upper lower upper lower middle lower upper lower class
violetmarian: middle middle lower upper class
danakarl: upper lower lower lower middle lower middle lower middle middle middle middle middle upper upper middle upper upper middle upper class
frankstan: upper upper lower upper lower class
johnmark: upper lower upper middle middle upper middle upper middle lower upper upper upper upper upper middle upper middle upper class
annesue: upper upper middle middle upper upper lower upper lower middle lower upper upper middle lower lower middle upper middle class
xaviertom: middle lower lower upper lower lower lower lower lower upper class
davidgary: middle upper middle lower lower middle upper class
dickdavid: upper lower lower lower lower lower lower upper middle upper middle class
rickanne: middle lower lower lower middle lower lower upper middle upper lower lower lower middle upper upper upper lower middle lower middle lower lower upper lower lower middle class
tommymona: middle lower middle lower lower upper lower middle upper lower lower lower upper class
josegary: upper middle lower upper upper upper upper upper lower middle middle upper lower upper middle class
jeffmark: middle upper middle lower middle middle lower lower upper lower upper lower lower upper upper lower lower upper lower upper upper upper upper upper upper lower class
richanne: lower upper lower class
richardanne: upper upper middle lower upper upper middle upper middle lower upper middle middle upper upper lower upper upper lower class
mariancharles: lower lower lower middle lower lower middle upper middle upper lower upper lower middle upper lower middle middle middle class
bobbob: middle upper middle middle middle upper upper upper lower middle upper middle middle upper lower middle middle class
rickrick: lower lower middle lower lower middle class
garymary: lower lower lower lower upper class
carlabea: upper middle upper upper upper upper lower upper middle upper lower upper lower upper lower lower lower lower lower middle upper lower upper class
tombill: middle upper middle upper middle upper lower upper middle upper upper lower upper middle upper middle upper lower lower upper upper lower lower middle class
monicacarla: upper upper lower lower middle middle lower lower lower class
stantom: middle upper middle lower upper upper lower middle upper middle upper lower class
beastanley: upper lower upper lower middle upper upper class
annecarl: lower upper middle middle lower middle class
tommyxavier: upper upper class
stanleyjeff: middle upper middle upper upper upper lower upper lower lower upper middle lower upper middle class
rickjack: upper middle lower middle upper lower upper upper upper upper middle upper upper middle middle middle upper middle middle middle middle lower middle middle middle lower upper class
franzstan: middle lower middle lower lower lower upper lower lower upper lower middle lower lower middle middle middle upper lower lower lower upper lower upper upper upper lower class
wendybill: lower upper middle lower middle upper lower class
violetanne: lower class
charleswendy: middle lower middle middle class
markpatricia: lower upper upper middle middle middle upper upper lower lower middle class
harrydick: upper upper lower middle middle upper lower lower upper lower middle class
billsue: lower middle class
monicajack: lower middle middle middle lower middle upper class
annejohn: middle lower lower lower middle lower upper class
wendyjack: lower lower upper middle upper upper lower upper lower upper middle upper lower middle middle upper middle lower lower upper middle middle upper lower class
harrystan: upper lower lower upper lower lower upper upper lower middle class
carlarick: lower middle middle middle upper class
markarnold: middle middle middle upper upper middle lower middle middle middle upper upper lower class
patriciajack: upper lower middle lower lower middle upper upper middle lower lower middle upper upper middle upper upper middle upper upper middle upper lower lower class
bobluann: lower middle lower lower upper lower upper lower lower upper middle upper middle upper middle middle middle class
tommykarl: upper upper middle upper upper lower upper lower middle lower lower middle middle upper lower upper lower lower middle class
monicasue: middle upper middle middle middle middle upper upper upper middle class
marydick: upper upper lower middle middle upper middle lower middle upper lower lower upper upper upper lower upper upper middle upper middle lower middle class
violetjose: middle middle class
annefranz: upper class
karldeanna: middle upper middle lower middle lower middle middle lower upper middle middle lower lower upper upper upper upper lower middle lower upper middle class
dickdeanna: middle lower middle class
annedana: middle upper lower upper upper lower upper class
wendyarnold: lower upper upper upper lower class
xavierdana: middle upper middle upper middle lower middle lower upper upper lower upper middle lower upper lower upper lower middle class
marianed: middle middle middle upper upper lower middle upper lower middle middle middle upper middle middle middle upper lower upper lower class
stanxavier: middle lower lower middle upper lower lower upper middle upper middle lower class
markcarl: middle lower lower middle lower middle lower middle upper class
tommypati: middle middle middle middle middle middle middle upper lower middle upper middle middle middle middle lower upper middle middle lower lower class
violetdavid: upper upper upper upper middle class
karldana: middle lower upper class
bobmonica: lower middle middle lower upper lower upper lower lower upper middle upper middle lower middle middle upper middle middle lower lower upper lower upper class
deannapeter: lower middle upper class
richarnold: middle upper lower upper lower lower upper lower upper lower lower upper middle lower middle middle upper lower middle class
stanleyfranz: upper lower lower middle middle upper upper lower middle upper upper upper upper upper lower upper class
hansmarian: upper middle middle lower middle upper upper middle class
deannarich: upper upper upper middle middle lower middle upper middle middle lower lower class
suesue: lower middle middle lower lower upper middle middle middle middle lower middle lower upper class
harrycarl: middle lower upper middle class
johnpeter: upper upper upper lower middle class
franzxavier: middle class
garyviolet: lower upper lower middle lower upper lower middle upper lower upper middle middle middle upper lower class
xaviersue: lower lower lower upper middle class
violettom: upper middle upper upper lower middle lower middle middle lower upper lower middle lower upper middle class
monicarichard: middle class
garytom: upper class
harryluann: lower upper upper lower upper lower lower upper middle lower lower upper middle middle middle middle lower lower lower lower middle lower middle upper lower lower lower class
petered: upper middle upper upper middle lower upper lower upper lower upper lower middle lower middle lower lower upper lower upper upper lower class
violetrich: lower upper lower upper lower upper lower middle lower middle upper middle upper middle upper class
tomdavid: middle lower upper lower lower lower middle middle upper middle lower upper middle upper lower lower upper upper middle middle class
violetbill: lower lower middle middle lower lower middle lower class
stanmary: middle middle class
dickviolet: upper lower upper lower middle middle middle middle middle lower upper middle lower middle middle lower lower upper class
mariandick: upper lower lower upper class
jackcarl: upper upper upper middle upper lower middle upper lower middle middle lower lower upper middle upper lower lower middle middle lower middle middle middle lower class
garymark: upper lower middle upper middle middle class
monamonica: upper middle upper lower lower middle middle middle lower middle lower upper middle middle lower lower lower upper lower upper class
markdavid: lower lower upper upper upper middle middle lower lower lower upper lower upper upper lower middle middle upper middle upper lower lower lower middle lower middle class
carlluann: lower upper upper lower upper lower lower upper middle upper upper lower lower upper middle upper lower middle middle lower middle upper upper lower upper lower class
stancarl: middle middle middle lower upper class
monicastanley: lower middle middle upper upper class
marytommy: lower middle middle middle lower middle lower upper middle upper lower upper middle middle class
monicacarl: middle lower middle upper lower lower class
patriciamark: upper lower lower lower upper upper lower middle upper lower class
tomjeff: upper middle upper middle upper middle lower lower upper lower lower lower upper middle middle lower middle upper lower lower lower upper upper lower lower middle class
luannmarian: upper lower lower upper middle lower upper middle lower upper middle middle upper upper lower lower middle class
harrydavid: middle upper upper upper lower upper lower lower lower lower lower middle middle middle middle upper upper upper upper class
richgary: lower upper lower upper lower middle lower middle upper lower upper lower class
bobstan: middle middle middle middle upper middle upper upper upper upper upper middle middle middle lower middle lower lower lower middle upper lower upper class
violetmark: upper lower lower middle upper lower middle upper lower middle middle upper upper class
billstanley: middle upper lower upper class
carlaarnold: lower upper upper upper upper lower lower middle middle upper lower upper upper middle lower middle class
franztom: lower upper upper lower lower upper middle lower middle upper upper middle class
charlesmona: lower lower middle upper class
billwilliam: upper lower class
josemark: upper lower upper upper upper lower lower lower middle lower middle upper upper class
richardrick: lower middle middle lower lower upper class
josejeff: upper middle upper lower upper lower middle lower upper upper class
richcharles: lower upper lower middle lower lower lower lower lower upper middle lower lower middle class
stanleystan: middle upper middle middle lower upper lower lower lower upper middle lower middle lower middle middle lower upper lower middle middle middle class
hansstan: upper lower lower middle lower upper middle middle upper middle upper class
beastan: middle upper lower lower upper middle upper middle lower upper lower lower lower upper upper upper upper class
danapatricia: upper middle upper middle middle middle middle lower middle middle middle lower upper class
garykarl: middle upper lower lower lower middle middle middle upper upper middle upper lower lower middle lower lower middle lower class
patriciapatricia: middle upper upper lower upper upper lower middle upper lower lower upper upper middle upper lower lower upper upper middle lower middle lower lower upper upper class
franktom: upper middle middle middle middle upper upper upper lower upper middle middle upper upper class
monaanne: middle lower lower lower middle upper lower middle middle lower upper upper middle middle middle lower lower middle lower upper class
billkarl: middle lower lower upper middle upper upper middle lower lower middle middle upper middle middle upper lower lower middle upper upper middle middle class
charlesjack: middle middle middle lower upper lower lower upper upper upper middle upper upper upper class
bearichard: lower upper middle lower upper upper lower upper upper lower middle middle middle upper lower middle upper lower lower lower class
josexavier: upper upper lower middle middle middle middle lower lower middle upper lower middle upper upper middle middle upper upper upper upper upper middle lower middle middle class
wendydick: middle lower lower middle lower lower lower lower lower lower middle middle lower middle middle upper upper middle upper lower middle lower upper middle lower lower lower class
luannstanley: upper middle upper middle lower lower middle upper middle upper lower lower middle lower lower middle lower middle upper lower lower lower middle middle middle middle upper class
jeffhans: lower upper lower lower middle lower middle upper middle lower upper middle lower middle class
karlrichard: middle lower class
williamfrank: upper lower upper lower lower middle upper middle upper upper middle middle lower class
garyjohn: middle lower upper middle lower upper lower middle upper upper lower middle upper middle middle upper upper lower class
stanleytommy: upper upper middle middle middle lower class
bobwilliam: middle upper middle upper lower middle middle lower middle middle upper lower lower middle lower lower lower middle lower upper middle lower lower middle upper upper upper class
stanleyrichard: middle upper lower middle middle lower middle upper lower upper lower lower upper middle middle upper class
suedick: middle upper middle middle lower upper lower lower upper middle upper middle upper lower upper middle upper upper lower lower lower lower upper middle class
karlxavier: middle middle lower lower upper middle middle upper lower upper lower lower middle middle upper middle middle middle middle upper middle upper middle middle class
markmarian: lower middle lower lower middle class
marianviolet: upper middle lower middle lower class
monicamarian: upper upper upper lower middle upper middle upper lower middle class
billrich: lower middle middle upper middle middle lower lower middle upper middle middle lower lower lower middle lower class
dickpatricia: lower middle upper upper lower upper upper upper upper middle class
karlrich: upper lower upper middle upper upper upper upper middle upper middle middle upper class
josesue: lower lower upper middle upper middle middle upper middle upper lower lower upper upper lower upper lower upper upper lower upper lower upper lower lower lower class
johnrich: lower middle class
patriciastan: middle upper lower upper lower middle class
peterjohn: middle upper middle upper lower upper middle lower class
suerich: lower upper middle middle upper upper upper lower upper lower upper class
patimona: upper lower upper upper upper lower lower upper upper lower upper lower upper lower lower upper lower middle lower lower upper middle lower upper class
suewilliam: upper lower lower upper lower lower upper middle upper upper middle class
harryharry: middle lower middle upper upper lower lower upper middle middle upper lower lower middle upper upper upper upper class
garyrichard: lower lower lower middle lower middle lower lower lower middle upper upper upper middle middle class
tommydana: upper middle middle middle upper upper upper middle middle middle lower upper lower middle upper class
stancharles: upper class
patriciadana: upper upper upper upper lower lower class
josebill: upper upper middle middle middle middle class
arnoldviolet: middle lower middle lower upper upper upper lower lower middle middle upper upper middle middle middle lower upper lower lower lower middle lower class
jeffharry: lower lower upper lower middle upper lower middle upper lower lower upper upper lower middle middle middle upper lower middle lower upper middle lower lower lower class
charlesmarian: upper lower upper upper upper upper upper class
garyjack: lower middle upper upper upper class
johncarla: lower lower upper middle lower upper upper upper upper middle upper lower upper middle middle middle lower upper upper upper lower lower middle lower middle middle upper class
rickxavier: lower lower middle lower lower middle lower upper lower upper middle lower middle upper middle lower lower lower lower middle class
stanleyed: lower lower lower middle lower lower lower upper lower middle lower lower middle class
edmary: middle upper upper middle middle lower middle lower lower upper lower lower middle middle middle middle middle lower upper upper middle middle lower middle upper class
peterstan: upper upper lower middle upper middle upper lower middle middle middle middle middle middle lower lower lower upper upper middle upper middle lower middle middle middle upper class
deannawendy: upper class
johnmary: middle upper lower middle middle upper upper middle lower middle lower class
luannrichard: lower middle upper upper lower middle class
monaed: lower middle middle upper lower lower upper lower middle middle upper lower middle upper middle lower lower middle middle middle upper upper upper lower lower class
rickdick: middle upper lower middle lower upper upper middle lower lower lower lower middle middle middle lower lower lower middle upper upper middle class
hansmona: lower middle upper lower middle lower upper upper middle upper middle lower upper upper upper middle middle upper middle class
stanleypati: upper middle middle upper lower upper upper middle middle middle lower middle lower upper lower class
frankstanley: lower middle middle upper lower lower lower middle lower upper lower middle upper lower lower upper upper upper middle class
stanleyxavier: upper lower lower lower upper lower lower lower upper lower lower upper lower middle middle upper middle upper lower class
violetharry: middle middle lower middle upper lower middle lower middle middle lower class
jeffmary: upper upper middle lower upper middle lower middle upper upper lower lower lower lower middle lower middle middle middle lower middle middle middle lower lower upper class
franzjose: middle upper upper upper middle upper upper upper upper lower middle middle lower upper upper upper middle lower lower upper class
karlbob: upper lower middle middle upper upper middle upper lower lower middle lower lower lower lower class
garystanley: lower middle middle lower upper upper middle lower lower middle lower middle upper upper middle upper upper upper upper middle class
deannamarian: middle middle lower upper lower lower class
johnhans: lower lower upper middle middle upper middle upper lower middle upper middle upper upper upper lower lower middle upper upper lower middle class
josemarian: lower lower upper upper middle lower middle middle lower upper upper middle class
tommyjohn: upper middle middle middle upper upper lower middle class
karlcarla: lower middle lower middle upper upper lower lower lower lower upper lower upper upper upper middle upper upper class
patimarian: lower lower upper upper upper upper upper upper middle middle lower middle upper middle lower lower lower middle class
monacarla: upper lower upper middle upper class
deannaviolet: middle upper upper class
markwilliam: lower upper lower upper upper lower middle class
harryhans: upper middle lower middle lower middle middle lower middle upper lower upper middle lower lower middle upper class
williamdavid: lower middle middle upper lower lower upper upper upper upper lower lower middle upper middle class
billhans: middle lower upper lower upper lower middle middle lower middle lower class
richarddick: lower middle middle upper upper upper upper lower lower lower upper middle middle class
davidbea: middle upper upper upper middle upper lower upper lower upper lower upper lower middle class
monafranz: middle lower lower middle middle middle lower middle upper middle middle lower lower upper lower lower upper middle lower middle middle lower middle middle upper upper class
tommywendy: lower upper lower lower upper middle middle lower upper upper lower middle lower lower lower class
mariananne: middle lower lower upper lower middle lower lower middle lower upper upper upper middle middle class
frankviolet: upper lower lower middle lower lower middle middle upper middle middle upper upper lower middle lower middle upper lower lower upper upper upper upper class
hanspeter: lower middle lower upper middle middle upper middle upper lower lower lower lower lower middle upper lower middle upper lower upper middle lower middle class
carlajack: upper middle middle lower middle lower middle lower upper lower upper upper middle middle upper class
jeffanne: middle middle upper lower upper middle lower middle lower lower upper upper middle lower middle lower upper lower upper middle middle class
jackcarla: upper upper class
violetluann: lower lower lower lower upper upper lower lower lower upper lower lower class
arnoldpeter: upper middle lower middle middle lower upper middle middle upper upper upper middle middle upper middle middle lower middle middle upper upper upper middle lower middle class
edfrank: upper lower middle upper upper middle lower middle middle lower middle middle middle upper upper lower lower upper middle upper lower middle class
frankrichard: upper lower upper middle lower lower middle upper lower middle middle upper upper middle class
arnoldfrank: upper lower middle lower middle upper middle middle middle lower upper upper middle lower lower lower middle middle class
carlgary: lower lower upper middle middle middle middle middle lower upper lower middle lower lower lower upper lower lower lower lower middle upper upper lower class
eddeanna: upper lower upper upper lower lower lower upper lower middle lower class
tommypeter: upper middle upper upper lower lower middle upper upper middle middle lower middle middle lower middle upper lower middle class
tombea: lower class
jackrichard: upper middle lower lower class
deannawilliam: lower upper middle upper lower middle middle middle middle lower lower lower lower middle lower lower upper lower upper class
monahans: middle middle upper middle lower lower middle middle upper lower upper lower upper middle upper lower upper class
davidharry: upper upper lower middle lower middle middle upper middle lower lower lower lower upper lower upper upper upper middle lower lower upper lower middle lower class
charlesrichard: middle upper lower lower upper upper upper lower middle middle upper lower class
patipati: lower lower lower middle middle upper lower lower middle upper middle middle lower middle middle lower upper class
suedana: middle middle middle lower lower middle upper lower middle lower upper middle lower upper middle lower upper upper class
arnoldfranz: upper middle middle middle lower upper class
stanmark: middle middle middle upper class
jeffrick: upper middle lower lower lower upper middle lower lower lower lower middle class
patriciabill: upper lower lower upper middle lower upper lower lower lower middle upper lower middle lower upper upper upper lower upper lower upper upper middle class
franksue: upper middle upper lower middle middle upper class
harrymark: upper upper middle upper upper class
tomviolet: upper middle lower lower lower middle lower class
harrycarla: upper upper middle middle lower upper upper middle lower middle lower upper middle middle middle class
monicacharles: middle middle lower middle middle lower middle middle middle class
garymona: upper middle middle upper middle upper middle middle upper middle upper lower upper upper middle middle upper middle middle lower lower upper middle lower upper upper class
garysue: middle lower lower lower lower upper lower lower upper lower lower upper middle middle middle middle middle middle lower upper lower upper middle lower middle middle class
williampatricia: upper upper class
markfrank: lower upper upper middle upper upper lower upper lower upper lower middle lower upper middle upper lower lower upper upper middle class
patriciamary: upper middle upper upper upper class
charlesfranz: middle upper middle upper lower middle upper middle lower class
bobtommy: upper lower middle upper upper lower middle lower upper lower upper middle middle lower middle middle lower lower class
monicapatricia: lower lower middle middle middle middle lower middle upper middle middle lower lower upper middle upper lower class
davided: middle class
violetcarla: middle lower middle middle lower middle upper lower lower upper middle upper lower class
marianmona: upper middle upper middle upper lower class
johnanne: upper lower upper middle upper upper middle lower middle upper middle lower lower upper upper lower middle lower lower upper lower lower upper middle class
annekarl: upper upper upper lower lower middle upper upper lower middle class
beatommy: middle upper upper middle class
jackjeff: upper upper upper middle middle middle middle middle class
dickstanley: upper lower lower lower middle class
danawendy: middle upper lower lower lower upper middle middle upper lower upper lower class
bobstanley: middle lower middle upper upper lower lower lower upper middle upper lower upper class
tomdick: lower upper lower lower middle class
markstan: middle upper lower middle upper upper middle upper middle class
stanhans: middle lower upper lower lower upper upper upper lower middle lower lower upper lower upper upper middle upper lower upper middle middle class
billtom: lower lower lower upper lower lower lower lower upper lower middle upper middle middle middle lower lower lower upper upper lower class
beabill: lower middle class
joserich: lower lower upper lower lower middle lower upper middle lower middle lower class
xavierpeter: lower upper upper upper upper middle middle upper middle lower upper middle upper upper middle lower middle upper middle lower upper middle middle lower middle upper upper class
harrydana: middle lower lower lower middle lower middle middle upper middle lower lower middle middle lower lower lower middle lower upper middle class
marianfranz: middle upper upper lower class
hanspati: lower lower middle middle lower middle middle lower middle lower upper upper middle middle upper lower lower upper upper middle lower lower middle middle class
carlstanley: middle upper upper lower lower upper lower lower middle upper lower upper middle upper upper upper middle class
monatom: middle upper lower upper upper middle lower middle upper middle middle upper upper lower middle upper lower upper lower lower lower middle upper upper middle lower upper class
marypeter: upper middle lower lower upper middle upper lower lower lower lower lower lower middle lower lower lower lower upper upper middle middle lower lower lower lower class
josewilliam: middle middle middle lower lower lower lower middle upper class
karlkarl: upper lower middle lower upper class
dickrick: middle upper middle middle upper lower upper lower lower middle upper upper lower lower upper upper upper upper upper lower lower upper upper upper middle lower lower class
garybill: middle lower lower upper middle lower upper middle lower lower upper lower middle lower upper upper middle lower upper middle lower lower middle upper middle class
hansmark: middle upper middle middle middle lower lower upper middle lower class
davidhans: upper upper upper upper middle class
wendystan: upper upper upper upper upper upper upper upper upper lower middle middle middle upper class
frankmary: lower upper upper middle middle middle lower lower middle lower upper upper lower middle upper lower lower middle lower middle upper lower upper middle upper middle middle class
arnoldanne: middle upper class
wendybob: lower middle lower middle middle lower lower middle lower middle middle lower middle middle upper lower upper lower lower upper middle upper class
tomtom: middle middle middle lower class
jeffstanley: middle middle upper lower middle lower middle lower lower lower upper middle upper lower middle upper class
josedick: middle class
anneed: upper lower lower lower lower upper lower middle lower upper middle lower middle lower middle lower lower upper class
stanrick: middle lower upper upper upper middle upper middle middle middle lower lower middle lower class
stansue: upper middle middle upper upper lower upper middle upper lower middle lower middle middle upper lower middle middle lower lower lower upper lower middle class
daviddick: upper upper upper middle class
monarichard: middle middle upper middle middle upper middle middle upper upper middle lower lower upper lower lower middle upper upper lower lower middle upper class
deannacarl: middle middle middle lower upper upper upper middle lower lower middle lower lower middle upper class
harrypati: lower upper lower lower class
jackjack: middle lower middle lower upper middle lower lower lower lower middle upper class
stancarla: upper upper lower middle lower upper middle lower upper upper middle lower class
edfranz: lower upper lower middle lower middle upper lower lower upper middle lower lower upper middle lower lower upper upper lower upper upper middle lower upper class
xavierstanley: lower upper middle class
johndeanna: lower middle upper lower middle upper upper upper middle lower upper lower middle upper middle upper upper middle lower middle lower middle middle class
arnoldwendy: lower lower middle lower middle upper middle middle upper middle upper lower lower lower lower upper upper middle middle middle lower middle upper lower lower upper class
charlesmark: upper lower lower middle lower upper class
johnstan: middle middle middle middle upper upper middle lower middle upper lower upper lower middle middle lower middle upper middle class
monicabea: lower lower lower middle class
josemonica: lower lower lower upper lower middle middle class
luannhans: lower lower middle lower upper middle upper lower middle middle upper lower class
tommysue: middle lower upper middle lower middle upper lower middle upper upper middle class
danajack: lower middle lower middle upper lower upper upper lower upper upper upper lower middle upper upper lower lower lower class
richardsue: upper upper upper lower lower upper middle lower upper class
deannarichard: lower lower middle class
jackfranz: upper upper middle middle middle upper upper lower middle upper lower upper lower upper middle middle lower lower middle class
annerick: upper lower lower lower upper middle upper lower upper upper middle upper middle lower middle upper middle upper middle lower upper class
johnfrank: upper upper upper lower upper upper middle lower middle middle lower middle lower upper upper middle upper upper lower lower middle middle class
franzwilliam: upper middle lower lower middle class
williammarian: lower lower upper middle lower lower middle lower middle lower upper upper lower middle upper upper middle middle middle middle upper middle class
josekarl: upper upper lower lower middle lower upper lower upper lower lower middle upper upper lower upper lower lower upper middle lower lower upper middle class
charlesviolet: lower lower upper lower lower upper middle middle class
tomcarl: upper middle upper middle upper upper upper lower lower middle lower upper lower middle middle upper middle lower upper upper middle lower upper middle middle upper upper class
peterviolet: upper middle upper upper middle class
harryrich: middle upper middle upper middle upper upper middle middle lower upper upper middle lower class
arnoldmark: lower upper lower upper lower lower class
karlsue: lower upper upper middle upper upper class
peterfrank: upper middle middle upper middle upper upper lower lower upper upper upper lower lower lower lower middle lower middle lower middle middle upper upper lower upper middle class
williammark: lower upper lower lower upper middle upper middle lower lower lower middle middle middle lower lower lower class
johndick: middle middle lower middle middle upper middle lower middle lower upper lower middle middle lower lower middle middle upper class
garyrich: upper lower lower middle class
danaluann: upper upper middle upper upper upper lower lower lower upper middle middle middle class
jackstanley: lower lower upper upper lower middle lower upper upper class
jackfrank: upper upper upper upper middle middle upper lower middle upper middle middle middle class
luanncharles: middle upper lower upper middle upper middle lower lower class
harryjohn: lower upper middle middle upper lower middle middle middle upper upper middle middle middle upper lower upper lower lower upper lower lower middle middle middle class
patriciamarian: lower lower middle lower lower upper lower lower middle upper middle upper upper lower middle lower upper lower lower lower middle class
monicabob: upper middle class
rickjohn: middle lower middle lower middle upper middle upper middle lower middle lower class
richardmona: upper lower lower class
luannharry: middle upper middle middle lower middle upper upper class
marybea: upper upper upper middle middle lower lower lower lower upper lower middle middle middle middle middle upper middle upper middle class
xavierfranz: upper class
daviddavid: upper lower lower middle middle upper middle upper middle lower lower lower upper middle upper upper class
violetarnold: lower lower middle lower middle lower upper upper upper upper lower upper middle upper middle lower upper upper middle class
patirich: upper upper lower lower upper upper lower lower upper middle middle upper middle middle middle class
stanleyrich: middle upper lower lower class
williamgary: middle middle upper middle upper middle upper middle middle middle lower middle middle lower middle upper class
karlhans: upper upper middle middle middle lower middle upper lower class
stanleymary: lower middle lower middle lower lower upper middle upper lower middle class
violetjohn: middle lower middle middle middle middle middle middle upper middle middle lower upper upper middle lower middle upper middle upper upper upper middle lower middle lower middle class
harrycharles: lower upper middle upper upper middle lower middle middle class
carlamona: lower lower middle upper class
violetpati: upper middle middle upper lower upper upper middle middle middle lower middle upper upper middle middle middle middle upper lower middle lower lower upper upper upper lower class
luannkarl: middle upper middle middle lower class
franzbill: upper class
charleshans: upper class
monicajose: middle middle middle upper class
patijeff: lower upper middle lower middle upper upper middle middle lower middle lower lower lower lower upper middle lower lower upper middle class
tommary: middle lower lower class
deannadeanna: upper middle class
jackpeter: upper class
johnluann: middle class
rickkarl: middle lower upper upper upper lower lower middle lower class
wendyfrank: lower lower middle middle upper upper upper lower upper middle lower class
bobharry: upper middle upper lower upper upper middle upper upper lower upper middle lower upper lower lower lower lower lower lower middle lower upper class
josecharles: lower lower upper middle upper middle lower upper lower middle lower upper middle lower middle middle lower upper lower class
tomdana: middle upper lower middle lower lower upper middle middle lower middle middle upper middle upper class
richardfranz: lower middle upper class
davidmark: middle upper upper middle upper upper upper middle lower lower middle middle upper lower middle middle middle lower middle lower lower upper middle class
rickbob: upper upper middle middle middle lower class
williamfranz: lower lower lower upper lower lower upper class
luannfrank: upper lower class
monicakarl: lower lower middle upper middle upper middle upper middle upper lower lower middle lower upper lower middle upper middle middle lower upper upper middle upper upper upper class
carljack: lower middle upper upper lower middle upper lower lower upper middle lower upper upper lower upper lower middle upper upper lower upper upper upper middle middle class
tommyrichard: upper upper upper class
jackwilliam: lower middle middle lower lower middle middle lower upper middle middle lower upper upper upper lower lower upper lower middle lower class
jackgary: upper upper upper upper upper class
frankmarian: upper lower lower upper middle upper lower lower class
wendyrick: upper upper upper lower lower lower upper upper upper middle lower lower upper middle class
dickbill: lower middle lower upper lower upper lower lower middle upper upper middle upper lower lower upper lower middle lower upper middle upper lower upper upper class
bearich: lower upper upper middle middle upper class
davidfrank: middle middle upper middle class
franzrichard: middle upper upper lower middle upper lower middle class
carlbea: upper middle lower upper upper middle lower upper upper middle lower lower lower middle upper class
marianpati: lower lower class
frankjose: middle middle lower class
carltommy: middle lower lower lower middle lower middle lower lower middle lower upper upper middle middle upper class
jackdeanna: lower lower lower lower middle lower upper upper upper middle lower upper lower lower middle lower middle class
suetommy: upper lower lower middle lower lower middle upper middle lower middle upper lower middle lower middle middle lower middle class
deannadick: middle lower upper upper upper middle upper upper middle middle middle middle upper middle lower upper middle lower middle middle upper class
garypeter: lower lower upper upper lower upper lower upper lower lower lower middle lower lower class
williamed: lower middle lower upper lower class
hanstom: upper lower upper lower class
richkarl: upper middle lower lower middle class
mariancarl: middle lower upper lower middle lower middle middle class
dickwilliam: lower lower lower middle lower middle upper lower upper upper lower lower lower middle lower upper upper class
hansjohn: middle lower middle upper upper lower upper lower lower upper upper middle lower upper lower lower lower middle upper upper lower lower lower middle class
richwendy: middle middle middle upper lower lower upper upper lower middle middle class
xaviercarl: middle middle middle upper upper middle middle upper class
stanjack: lower upper lower lower lower upper lower middle lower middle lower lower class
markdana: upper middle upper middle lower lower middle upper lower upper lower class
carlmark: middle middle middle lower lower middle middle lower lower middle upper middle upper middle lower lower upper class
davidmary: upper upper middle lower lower lower middle upper middle middle upper upper class
richardgary: upper middle middle upper middle middle lower upper upper lower upper lower upper middle middle class
petermark: middle upper middle lower lower middle upper middle lower upper lower middle upper middle middle upper class
charlesrich: middle upper middle middle upper middle lower lower lower middle middle middle lower middle class
danastanley: upper lower upper upper middle upper middle upper middle middle class
xavierjeff: upper middle lower middle middle middle upper lower lower lower middle upper upper upper lower upper upper lower middle upper upper lower lower lower upper middle upper class
johnmonica: upper middle lower middle lower middle upper lower upper lower lower upper upper upper upper lower class
deannaarnold: upper lower middle lower middle middle upper upper lower upper middle lower upper lower lower upper lower lower upper class
johned: lower lower lower lower upper lower middle upper lower middle middle lower middle upper upper upper upper middle upper upper middle lower middle upper middle class
markstanley: upper upper middle upper middle middle lower middle lower lower middle middle middle lower lower middle lower middle lower middle lower upper middle middle middle lower middle class
richardcarl: lower middle lower middle middle upper upper lower middle lower middle lower middle upper lower middle upper class
tomharry: upper upper upper lower lower middle middle middle middle middle middle middle middle middle lower class
suefranz: lower lower lower lower lower upper middle middle lower lower middle lower middle middle middle lower lower lower lower middle lower upper class
violetmonica: upper upper middle upper upper lower lower lower lower upper lower middle middle upper middle upper lower lower class
edcarla: upper upper upper upper middle upper upper middle upper lower upper class
marysue: lower upper lower upper lower middle upper middle upper middle middle upper middle lower upper upper lower upper lower upper middle upper lower class
karlviolet: lower lower middle lower middle upper upper class
peterjack: lower lower middle middle lower middle upper middle middle upper middle lower lower middle middle middle class
peterrick: upper middle upper lower upper upper lower middle upper lower middle lower upper upper middle lower middle lower upper middle lower upper middle class
xavierwilliam: upper middle middle upper upper lower upper middle middle upper upper middle upper lower upper upper upper middle middle lower upper middle lower upper class
harrybill: middle middle middle middle middle lower lower middle upper lower middle lower lower lower middle lower upper lower class
xavierarnold: upper class
monicadick: middle upper middle lower lower lower middle middle class
harryrichard: lower upper middle middle upper upper middle lower upper lower upper upper upper class
charlesxavier: upper upper lower upper upper upper upper upper upper lower upper middle lower upper lower upper middle lower middle lower middle middle lower middle middle upper lower class
anneviolet: lower middle middle lower lower middle lower upper middle lower lower middle lower class
tommyjose: upper upper upper lower class
markmary: upper middle lower upper upper lower upper lower middle upper middle lower middle lower lower upper class
bobcarla: lower middle lower lower lower middle lower middle lower middle lower upper class
richcarla: upper middle upper middle class
jeffjack: upper lower upper upper lower lower upper middle middle lower lower upper lower middle lower middle upper lower middle middle lower upper lower upper upper lower lower class
marystanley: lower middle middle upper upper upper lower upper middle upper lower upper upper middle lower upper upper lower lower middle middle upper upper lower lower class
rickrichard: upper lower lower middle upper middle lower lower upper class
billharry: lower lower upper middle upper lower upper upper lower lower middle lower upper middle middle upper upper middle upper upper upper upper middle upper lower class
garyjose: upper lower lower lower upper middle class
markharry: upper lower upper lower upper middle middle upper middle upper middle upper upper middle middle lower middle upper upper lower middle class
garyfrank: upper lower middle middle upper middle lower middle upper class
garybob: lower lower middle lower middle lower middle upper middle upper middle lower lower lower upper lower upper upper upper class
danamark: lower upper upper lower middle middle middle middle middle upper upper lower lower upper middle middle upper lower lower lower lower upper class
tommyrich: lower middle upper middle upper middle upper middle lower middle middle upper upper lower middle middle class
jeffdeanna: lower middle upper lower upper lower upper middle upper upper upper middle upper middle middle middle lower middle upper middle lower lower middle upper class
patiharry: upper upper middle lower middle upper middle lower upper upper lower class
dickwendy: middle lower class
billstan: middle upper middle lower middle middle middle middle middle upper lower middle upper upper lower lower lower class
josedavid: upper upper lower lower upper middle upper middle upper upper upper middle lower middle lower class
hanshans: upper class
davidsue: upper middle middle middle lower middle middle middle upper middle lower upper upper upper upper class
luannxavier: middle middle upper upper lower upper upper upper lower class
riched: middle middle upper upper upper middle upper lower lower upper upper lower upper middle middle middle class
harryrick: upper upper lower middle lower lower lower middle lower upper lower lower lower lower middle upper upper middle upper lower upper upper middle middle class
edanne: lower upper middle middle upper middle middle middle upper lower lower middle middle upper middle middle upper lower middle middle middle upper middle upper class
annestanley: upper middle upper lower upper middle lower middle lower upper lower lower upper lower upper lower lower upper lower lower class
patriciadeanna: upper middle upper lower middle middle lower lower upper lower upper lower lower lower lower lower middle middle middle middle lower class
billwendy: lower class
maryluann: middle middle class
richardpati: middle middle upper upper middle lower middle lower upper upper middle lower upper middle upper middle middle upper middle lower class
harrystanley: middle upper lower upper middle middle middle middle middle middle lower lower lower upper lower class
deannaed: middle upper middle lower class
tomdeanna: middle lower upper lower middle lower lower middle lower upper middle class
carlapeter: middle lower middle class
danamonica: middle middle middle middle upper upper middle middle lower middle lower upper lower middle upper upper middle lower middle upper middle upper middle lower upper upper class
carldick: lower lower upper upper lower upper lower lower middle lower upper upper upper lower middle upper upper lower middle upper upper upper lower upper lower middle class
monicaluann: lower lower middle lower middle lower middle upper middle middle lower class
monafrank: lower middle lower middle upper middle upper middle upper middle middle upper upper class
stanleyrick: middle lower lower upper middle middle middle upper middle middle upper class
xavierrich: upper middle upper middle lower middle lower middle upper middle middle upper upper lower middle upper upper middle upper upper upper middle middle middle lower middle lower class
karldavid: upper middle upper middle lower lower upper lower upper class
stanwilliam: lower lower lower lower upper middle upper lower lower lower upper lower upper upper middle class
jeffmona: lower lower lower upper class
monicagary: upper lower lower middle class
frankdavid: upper lower lower lower middle upper upper upper middle middle middle middle upper lower upper lower middle middle middle class
carled: middle lower middle lower lower upper middle lower middle middle lower upper lower lower upper middle middle class
marksue: middle upper lower middle lower middle middle upper upper middle middle upper lower upper lower upper middle upper lower middle upper lower upper upper class
marymarian: lower lower upper middle middle upper upper upper upper lower middle lower lower lower class
franzarnold: upper upper upper lower middle upper upper lower lower lower class
edmarian: middle lower upper upper lower upper class
arnoldrich: upper upper upper lower lower middle middle class
johnmona: upper upper upper lower lower lower lower upper lower middle lower upper lower lower middle class
arnoldjose: upper middle upper middle lower lower upper middle middle upper lower middle middle middle middle middle upper lower upper lower lower upper middle upper lower middle class
williamjohn: upper upper upper lower middle lower lower upper upper lower lower middle middle middle upper middle lower upper class
wendymonica: upper middle upper middle lower middle lower lower upper upper lower middle lower upper lower lower middle upper upper middle lower lower upper middle middle lower middle class
suemarian: middle middle upper middle middle upper middle lower middle middle lower lower middle lower upper middle lower middle middle middle middle middle middle middle middle middle class
tomhans: middle upper upper middle lower lower class
johnbill: lower class
stanleymonica: middle lower middle upper upper upper middle lower upper middle upper middle upper middle upper lower middle lower lower class
violetfranz: middle middle lower class
patriciarichard: middle lower lower middle middle upper middle middle upper middle middle middle upper middle lower middle upper upper middle middle class
xavierbob: middle middle middle upper middle lower upper lower lower lower upper middle lower upper class
monadana: middle upper upper middle middle upper class
billpati: upper upper middle upper upper lower middle upper class
charlespati: lower middle middle lower upper lower upper lower lower middle lower upper upper middle lower lower middle lower middle middle upper lower middle middle upper lower upper class
luannmary: middle upper lower upper upper class
tomstanley: lower lower lower upper lower upper lower upper middle middle lower lower middle lower upper middle lower upper upper upper upper upper lower class
arnolddick: middle upper upper upper upper upper upper lower class
williamstanley: lower lower class
dickgary: middle upper upper lower upper upper lower middle class
hansfrank: upper lower lower upper middle upper middle lower upper middle upper middle class
monajose: lower lower upper upper class
franzsue: upper upper upper middle upper upper lower upper class
johnsue: lower upper lower upper lower upper lower lower upper lower lower middle middle upper upper middle lower lower lower middle class
charlesbea: middle lower upper upper middle middle middle middle lower middle lower lower middle middle middle lower upper lower middle upper upper class
danacharles: upper upper middle middle lower lower upper upper upper upper upper middle lower lower upper middle lower lower upper lower lower middle upper middle lower lower class
arnoldarnold: lower upper upper upper lower lower lower lower upper middle middle middle middle middle upper upper lower upper lower middle middle upper middle class
dickbea: middle middle middle lower middle upper upper lower upper middle middle lower upper middle upper lower upper class
davidjack: lower middle middle lower lower lower lower middle middle lower lower middle upper upper upper class
monicarich: upper middle lower middle upper middle lower lower middle middle middle middle upper middle lower lower upper lower class
richmary: upper upper middle lower middle upper lower upper middle upper lower lower class
garyanne: upper lower middle lower upper middle lower lower middle middle lower upper lower upper lower upper upper middle middle upper middle upper lower lower upper class
arnoldsue: lower lower lower lower middle lower lower lower lower lower lower middle lower lower middle upper lower upper lower middle middle middle class
markrich: middle upper class
danajose: lower upper lower middle middle middle lower middle lower middle middle lower middle upper upper middle middle middle lower middle class
edjohn: lower lower upper lower middle middle lower lower lower middle upper upper upper lower middle middle lower upper class
richmark: middle lower upper upper upper lower lower upper upper lower upper middle lower upper class
stanleyfrank: lower upper upper upper lower lower lower middle middle upper lower middle middle middle middle middle middle lower middle lower lower lower lower lower class
rickmona: upper upper middle lower middle upper upper upper upper class
luannstan: lower middle upper middle middle upper upper upper middle class
beatom: middle middle middle middle lower upper upper upper middle upper middle upper lower upper lower upper lower middle class
dickbob: middle middle upper upper upper upper lower upper middle middle lower middle upper upper lower middle upper upper upper upper middle class
edstan: upper middle upper middle upper lower upper middle upper class
danarichard: lower middle middle lower middle middle middle upper middle lower upper lower lower upper upper upper upper upper lower lower lower class
deannaxavier: lower middle lower lower upper lower upper lower lower upper lower lower upper upper upper middle upper lower lower class
monamark: middle middle upper upper lower lower lower middle upper upper lower middle upper upper upper upper lower lower middle middle lower class
dickcarla: lower middle middle upper lower upper lower lower middle upper lower lower lower middle lower middle middle class
annedick: lower middle middle lower middle upper lower lower upper lower middle upper middle upper lower upper middle middle middle lower middle lower lower class
tommyed: middle lower middle middle upper middle middle middle lower lower middle upper middle upper upper upper lower lower upper lower middle lower upper lower lower lower lower class
sueed: middle middle lower upper upper lower lower middle lower middle middle middle middle lower class
stanfrank: upper upper class
petertommy: lower lower lower upper upper lower middle upper lower middle middle upper upper upper lower class
franked: middle middle lower upper upper middle middle lower lower lower class
deannaharry: middle lower upper lower lower upper upper upper upper upper class
jackpatricia: lower lower middle lower lower upper middle upper middle middle class
petergary: middle lower upper middle lower upper middle lower middle upper lower lower middle lower middle middle middle lower lower middle middle lower lower class
davidviolet: lower middle upper middle lower middle lower middle upper lower lower upper upper middle upper upper upper lower upper upper lower lower middle upper middle lower middle class
davidxavier: lower middle upper lower lower lower lower lower lower class
patimonica: middle middle lower lower class
tommytommy: lower upper middle class
marianrick: lower middle middle middle lower middle class
williamdana: middle lower upper middle middle lower class
jeffed: lower upper lower lower lower middle lower upper upper middle middle lower upper lower lower middle upper middle lower lower middle lower lower upper middle upper lower class
frankpatricia: middle lower upper upper upper upper upper middle middle middle lower upper lower upper middle middle class
frankjohn: upper upper lower upper class
tomrichard: upper lower middle upper upper upper lower middle lower upper lower middle upper lower lower lower lower middle upper middle class
franzpati: lower lower middle lower middle upper lower upper upper upper upper lower lower upper lower lower lower upper upper upper middle class
tomed: upper upper lower lower lower upper upper lower class
harryjose: middle lower lower lower lower lower lower upper middle lower lower middle upper upper middle middle upper middle upper middle lower class
wendykarl: middle middle middle lower middle upper lower lower middle middle upper upper class
beaxavier: upper middle middle upper middle upper middle lower upper middle upper middle upper lower middle middle upper upper middle lower upper class
petermona: upper upper middle class
charlesstanley: upper upper class
johnjose: upper middle upper upper upper middle middle middle middle lower middle middle lower lower middle lower upper lower upper upper middle upper middle class
luannsue: lower middle middle upper middle middle upper class
xavierjack: lower lower upper middle upper middle middle upper middle upper upper lower lower lower lower upper middle middle lower upper lower lower middle lower upper class
hansgary: middle lower lower lower class
beapati: upper lower lower middle middle class
xaviermarian: middle lower middle middle class
deannacarla: lower class
tommyfrank: middle lower middle lower lower class
danadick: middle lower lower lower class
suemona: upper lower middle middle middle class
tommymarian: lower upper lower lower lower upper lower upper upper lower middle lower middle lower lower upper lower lower lower middle class
annemonica: middle lower upper middle upper middle upper middle upper lower middle lower middle upper lower upper middle lower lower lower upper upper middle upper lower upper middle class
arnoldharry: middle lower upper middle class
stanstanley: upper upper lower upper upper middle middle upper middle middle middle class
jeffbea: lower upper lower middle middle upper lower upper middle lower lower lower middle lower lower middle lower middle upper upper upper upper middle middle lower upper class
ricked: upper upper middle upper middle upper upper lower upper lower lower middle middle lower middle lower lower class
violetstan: middle upper middle middle middle upper upper lower upper lower upper middle lower lower lower middle lower middle lower middle middle class
paticharles: middle middle lower lower middle lower middle middle lower middle lower upper lower lower lower upper class
violetdana: upper middle middle upper upper lower lower middle lower lower middle lower lower lower upper upper middle lower upper upper lower class
patriciacarla: lower middle lower lower middle upper lower lower class
carlajohn: middle class
charlesstan: middle upper middle lower upper upper lower upper upper upper upper upper middle middle middle class
monicahans: upper lower lower upper upper lower upper middle middle middle lower upper class
billrichard: upper lower upper lower middle upper lower upper middle middle middle lower lower lower middle lower middle lower lower middle class
harryfranz: middle lower middle middle middle upper class
monarick: lower middle class
carlakarl: lower middle middle middle upper lower upper lower class
carlkarl: lower upper upper upper upper upper lower middle upper lower middle upper upper class
petersue: lower middle lower lower class
monabea: upper middle lower middle upper upper middle lower class
suemonica: middle class
patistanley: lower lower upper upper lower lower upper class
danastan: lower middle upper upper lower class
marycarla: lower lower middle upper upper upper upper lower lower middle upper middle lower middle middle upper middle middle middle lower upper middle upper lower lower middle upper class
sueharry: upper class
danarick: lower upper upper lower lower lower lower lower middle upper upper middle middle lower lower lower upper lower upper middle middle lower middle middle class
franzpeter: upper upper middle upper middle upper lower lower middle upper upper class
carlafranz: lower upper upper lower upper class
standana: upper middle upper upper upper middle middle lower upper lower lower class
josecarl: upper middle upper upper lower upper lower middle upper lower upper lower upper class
williampeter: upper upper middle middle middle upper lower middle middle upper upper lower middle upper middle middle middle middle lower class
xavierdick: lower lower middle lower lower lower middle upper lower middle upper upper upper upper class
monicajeff: upper lower lower upper lower upper upper upper lower upper upper lower upper lower upper middle middle middle upper middle upper class
danapati: upper upper lower middle upper middle class
maryviolet: middle lower middle middle lower lower lower middle middle upper lower middle middle upper lower middle lower lower upper middle lower upper middle class
sueviolet: middle upper upper upper upper middle upper lower lower middle upper middle lower middle middle middle upper upper lower lower middle middle lower middle upper middle class
patriciahans: lower middle middle lower middle middle upper upper upper upper middle lower lower upper upper middle middle upper upper upper class
joseluann: middle lower lower upper middle upper upper upper lower upper lower upper lower upper upper upper middle middle middle lower lower middle middle class
arnoldjack: upper middle lower middle upper middle middle lower middle middle upper middle upper lower lower middle lower middle lower lower lower middle middle lower lower lower middle class
peterpatricia: middle middle upper middle lower lower lower middle upper lower middle lower upper upper middle middle middle middle lower middle class
richmonica: lower middle upper lower middle lower lower lower lower middle lower lower middle lower lower upper lower upper lower middle class
annejose: lower lower lower lower class
karljohn: lower upper lower middle middle middle upper middle middle middle middle middle upper middle lower upper class
johnviolet: middle upper lower class
franzfranz: upper upper lower lower upper upper lower class
garymonica: middle middle upper upper lower middle upper upper class
davidjohn: lower lower lower class
johntom: middle lower middle lower lower lower upper middle middle middle lower middle lower lower lower upper middle class
josejohn: lower upper class
danasue: middle upper upper upper middle lower class
dicked: upper middle middle lower lower lower lower middle upper lower lower lower middle upper upper middle middle middle upper upper upper class
stanmona: upper lower middle upper upper lower class
xaviermona: lower upper upper lower lower class
deannamona: lower lower upper upper class
monarich: lower middle lower upper upper middle middle lower upper lower upper upper middle middle class
peterfranz: middle middle upper middle upper class
patipatricia: upper middle middle middle lower middle middle middle middle lower lower middle lower middle upper middle middle upper middle lower class
petercharles: upper lower lower middle upper lower middle upper middle middle lower upper upper middle lower upper lower upper lower middle middle upper upper upper upper upper class
danamary: middle lower middle lower middle upper lower lower lower upper upper lower upper upper upper lower middle lower upper lower class
xavierpatricia: upper middle upper upper lower class
jefftommy: middle upper lower upper upper middle upper lower lower middle middle middle upper lower lower upper lower upper upper lower lower middle middle upper middle class
suerick: lower upper lower upper middle middle lower lower lower upper middle middle upper middle middle lower lower middle middle upper lower class
stanleykarl: upper lower lower upper lower middle lower lower upper upper upper upper middle middle lower middle class
carlarich: upper upper upper middle lower middle upper middle upper middle upper upper middle lower middle lower middle middle middle lower middle upper upper lower lower upper lower class
dickrichard: lower upper middle upper upper lower middle upper middle lower upper middle middle upper middle lower lower lower upper middle lower lower middle lower lower class
karlpatricia: lower middle lower lower lower class
